ord,edo,edon,inegi,mun,ptot,hombres,mujeres
1,ags,1,0,Total Entidad,862720,422324,440396
2,ags,1,1,001 Aguascalientes,582827,283536,299291
3,ags,1,2,002 Asientos,35762,17954,17808
4,ags,1,3,003 Calvillo,51658,25627,26031
5,ags,1,4,004 Cosio,12136,5994,6142
6,ags,1,5,005 Jesus Maria,54476,26909,27567
7,ags,1,6,006 Pabellon De Arteaga,31650,15477,16173
8,ags,1,7,007 Rincon De Romos,38752,19198,19554
9,ags,1,8,008 San Jose De Gracia,7170,3492,3678
10,ags,1,9,009 Tepezala,16175,8100,8075
11,ags,1,10,010 Llano,14278,7268,7010
12,ags,1,11,011 San Francisco De Los Romo,17836,8769,9067
13,bc,2,0,Total Entidad,2112140,1064591,1047549
14,bc,2,1,001 Ensenada,315289,158779,156510
15,bc,2,2,002 Mexicali,696034,349323,346711
16,bc,2,3,003 Tecate,62629,31933,30696
17,bc,2,4,004 Tijuana,991592,500557,491035
18,bc,2,5,005 Playas de Rosarito,46596,23999,22597
19,bcs,3,0,Total Entidad,375494,191013,184481
20,bcs,3,1,001 Comondú,66096,33385,32711
21,bcs,3,2,002 Mulegé,45963,23714,22249
22,bcs,3,3,003 Paz,182418,91658,90760
23,bcs,3,8,008 Cabos,71031,37179,33852
24,bcs,3,9,009 Loreto,9986,5077,4909
25,cam,4,0,Total Entidad,642516,322991,319525
26,cam,4,1,001 Calkiní,43799,21823,21976
27,cam,4,2,002 Campeche,204533,100298,104235
28,cam,4,3,003 Carmen,179690,90768,88922
29,cam,4,4,004 Champotón,80066,41267,38799
30,cam,4,5,005 Hecelchakán,23417,11714,11703
31,cam,4,6,006 Hopelchén,41745,21709,20036
32,cam,4,7,007 Palizada,7903,4045,3858
33,cam,4,8,008 Tenabo,7630,3916,3714
34,cam,4,9,009 Escárcega,53733,27451,26282
35,coa,5,0,Total Entidad,2173775,1080594,1093181
36,coa,5,1,001 Abasolo,1290,662,628
37,coa,5,2,002 Acuña,81602,41484,40118
38,coa,5,3,003 Allende,19917,9887,10030
39,coa,5,4,004 Arteaga,18907,9746,9161
40,coa,5,5,005 Candela,1713,870,843
41,coa,5,6,006 Castaños,21924,11050,10874
42,coa,5,7,007 Cuatrociénegas,12899,6610,6289
43,coa,5,8,008 Escobedo,2843,1445,1398
44,coa,5,9,009 Francisco I. Madero,47510,23716,23794
45,coa,5,10,010 Frontera,63847,31903,31944
46,coa,5,11,011 General Cepeda,11913,6334,5579
47,coa,5,12,012 Guerrero,2144,1177,967
48,coa,5,13,013 Hidalgo,1271,674,597
49,coa,5,14,014 Jiménez,9328,4841,4487
50,coa,5,15,015 Juárez,1588,822,766
51,coa,5,16,016 Lamadrid,1832,923,909
52,coa,5,17,017 Matamoros,88235,44062,44173
53,coa,5,18,018 Monclova,189738,94304,95434
54,coa,5,19,019 Morelos,6642,3295,3347
55,coa,5,20,020 Múzquiz,62990,31391,31599
56,coa,5,21,021 Nadadores,6187,3198,2989
57,coa,5,22,022 Nava,20502,10529,9973
58,coa,5,23,023 Ocampo,13389,7103,6286
59,coa,5,24,024 Parras,43303,21972,21331
60,coa,5,25,025 Piedras Negras,116148,57456,58692
61,coa,5,26,026 Progreso,3613,1857,1756
62,coa,5,27,027 Ramos Arizpe,36440,18551,17889
63,coa,5,28,028 Sabinas,51129,25320,25809
64,coa,5,29,029 Sacramento,1955,1029,926
65,coa,5,30,030 Saltillo,527979,262592,265387
66,coa,5,31,031 San Buenaventura,20034,10001,10033
67,coa,5,32,032 San Juan de Sabinas,40731,19920,20811
68,coa,5,33,033 San Pedro,91421,46009,45412
69,coa,5,34,034 Sierra Mojada,6594,3504,3090
70,coa,5,35,035 Torreón,508076,247004,261072
71,coa,5,36,036 Viesca,19510,9844,9666
72,coa,5,37,037 Villa Unión,6228,3199,3029
73,coa,5,38,038 Zaragoza,12403,6310,6093
74,col,6,0,Total Entidad,488028,242787,245241
75,col,6,1,001 Armería,28015,14182,13833
76,col,6,2,002 Colima,120781,58839,61942
77,col,6,3,003 Comala,17601,8805,8796
78,col,6,4,004 Coquimatlán,16939,8466,8473
79,col,6,5,005 Cuauhtémoc,25462,12736,12726
80,col,6,6,006 Ixtlahuacán,4989,2518,2471
81,col,6,7,007 Manzanillo,108584,54763,53821
82,col,6,8,008 Minatitlán,8321,4309,4012
83,col,6,9,009 Tecomán,91036,45737,45299
84,col,6,10,010 Villa de Álvarez,66300,32432,33868
85,cps,7,0,Total Entidad,3584786,1790580,1794206
86,cps,7,0,Otros Municipios,519686,260492,259194
87,cps,7,1,001 Acacoyagua,12607,6576,6031
88,cps,7,2,002 Acala,23553,11830,11723
89,cps,7,3,003 Acapetahua,25647,13156,12491
90,cps,7,5,005 Amatán,15187,7833,7354
91,cps,7,6,006 Amatenango de la Frontera,23200,11731,11469
92,cps,7,7,007 Amatenango del Valle,6775,3287,3488
93,cps,7,8,008 Ángel Albino Corzo,24094,12486,11608
94,cps,7,9,009 Arriaga,39164,19531,19633
95,cps,7,10,010 Bejucal de Ocampo,6126,3155,2971
96,cps,7,11,011 Bella Vista,16803,8607,8196
97,cps,7,12,012 Berriozábal,26301,13411,12890
98,cps,7,15,015 Cacahoatán,35738,18029,17709
99,cps,7,16,016 Catazajá,15689,8105,7584
100,cps,7,17,017 Cintalapa,63600,31895,31705
101,cps,7,18,018 Coapilla,6435,3291,3144
102,cps,7,19,019 Comitán de Domínguez,95260,46347,48913
103,cps,7,20,020 Concordia,37456,19440,18016
104,cps,7,21,021 Copainalá,17035,8616,8419
105,cps,7,22,022 Chalchihuitán,9901,5017,4884
106,cps,7,23,023 Chamula,52942,26015,26927
107,cps,7,25,025 Chapultenango,6388,3227,3161
108,cps,7,27,027 Chiapa de Corzo,58825,29490,29335
109,cps,7,28,028 Chiapilla,4770,2447,2323
110,cps,7,29,029 Chicoasén,3906,2017,1889
111,cps,7,30,030 Chicomuselo,26392,13565,12827
112,cps,7,31,031 Chilón,69946,35375,34571
113,cps,7,32,032 Escuintla,26282,13241,13041
114,cps,7,33,033 Francisco León,4061,2085,1976
115,cps,7,34,034 Frontera Comalapa,50012,25283,24729
116,cps,7,35,035 Frontera Hidalgo,9852,4967,4885
117,cps,7,36,036 Grandeza,5644,2897,2747
118,cps,7,37,037 Huehuetán,30356,15316,15040
119,cps,7,40,040 Huixtla,47644,23533,24111
120,cps,7,42,042 Ixhuatán,7796,3979,3817
121,cps,7,43,043 Ixtacomitán,8180,4099,4081
122,cps,7,44,044 Ixtapa,16402,8127,8275
123,cps,7,45,045 Ixtapangajoya,4515,2253,2262
124,cps,7,46,046 Jiquipilas,35403,18002,17401
125,cps,7,47,047 Jitotol,11403,5802,5601
126,cps,7,48,048 Juárez,20451,10375,10076
127,cps,7,49,049 Larráinzar,14944,7476,7468
128,cps,7,50,050 Libertad,5141,2599,2542
129,cps,7,51,051 Mapastepec,39293,20080,19213
130,cps,7,53,053 Mazapa de Madero,7498,3772,3726
131,cps,7,54,054 Mazatán,23293,11893,11400
132,cps,7,55,055 Metapa,4381,2169,2212
133,cps,7,56,056 Mitontic,6506,3197,3309
134,cps,7,57,057 Motozintla,53143,27097,26046
135,cps,7,58,058 Nicolás Ruíz,3308,1706,1602
136,cps,7,60,060 Ocotepec,7341,3648,3693
137,cps,7,61,061 Ocozocoautla de Espinosa,58705,29535,29170
138,cps,7,62,062 Ostuacán,13795,7033,6762
139,cps,7,63,063 Osumacinta,3029,1585,1444
140,cps,7,65,065 Palenque,77998,39449,38549
141,cps,7,66,066 Pantelhó,14073,7050,7023
142,cps,7,67,067 Pantepec,7061,3575,3486
143,cps,7,68,068 Pichucalco,25987,13103,12884
144,cps,7,69,069 Pijijiapan,47616,24259,23357
145,cps,7,70,070 Porvenir,10574,5338,5236
146,cps,7,71,071 Villa Comaltitlán,25535,13067,12468
147,cps,7,72,072 Pueblo Nuevo Solistahuacán,20819,10315,10504
148,cps,7,73,073 Rayón,6167,3126,3041
149,cps,7,74,074 Reforma,32283,16292,15991
150,cps,7,75,075 Rosas,19503,9654,9849
151,cps,7,77,077 Salto de Agua,45450,22838,22612
152,cps,7,78,078 San Cristóbal de las Casas,116729,56194,60535
153,cps,7,79,079 San Fernando,23047,11977,11070
154,cps,7,80,080 Siltepec,30777,15887,14890
155,cps,7,82,082 Sitalá,5940,2999,2941
156,cps,7,83,083 Socoltenango,13819,7027,6792
157,cps,7,84,084 Solosuchiapa,6926,3499,3427
158,cps,7,85,085 Soyaló,7062,3599,3463
159,cps,7,86,086 Suchiapa,14046,7165,6881
160,cps,7,87,087 Suchiate,28498,14087,14411
161,cps,7,88,088 Sunuapa,1431,714,717
162,cps,7,89,089 Tapachula,244855,119390,125465
163,cps,7,90,090 Tapalapa,3286,1587,1699
164,cps,7,91,091 Tapilula,8939,4472,4467
165,cps,7,92,092 Tecpatán,34988,17846,17142
166,cps,7,93,093 Tenejapa,27614,13612,14002
167,cps,7,94,094 Teopisca,22403,11072,11331
168,cps,7,96,096 Tila,48708,24543,24165
169,cps,7,97,097 Tonalá,73673,36852,36821
170,cps,7,98,098 Totolapa,4671,2355,2316
171,cps,7,99,099 Trinitaria,58827,29505,29322
172,cps,7,101,101 Tuxtla Gutiérrez,386135,186349,199786
173,cps,7,102,102 Tuxtla Chico,32395,16227,16168
174,cps,7,103,103 Tuzantán,22833,11597,11236
175,cps,7,104,104 Tzimol,10877,5489,5388
176,cps,7,105,105 Unión Juárez,12835,6557,6278
177,cps,7,106,106 Venustiano Carranza,51756,26414,25342
178,cps,7,107,107 Villa Corzo,63351,32367,30984
179,cps,7,108,108 Villaflores,79925,40045,39880
180,cps,7,109,109 Yajalón,24216,12055,12161
181,cps,7,110,110 San Lucas,4723,2424,2299
182,cps,7,111,111 Zinacantán,24631,11888,12743
183,cua,8,0,Total Entidad,2793537,1391914,1401623
184,cua,8,1,001 Ahumada,12694,6590,6104
185,cua,8,2,002 Aldama,19998,10125,9873
186,cua,8,3,003 Allende,9457,4811,4646
187,cua,8,4,004 Aquiles Serdán,3742,1900,1842
188,cua,8,5,005 Ascensión,19676,10083,9593
189,cua,8,6,006 Bachíniva,7242,3715,3527
190,cua,8,7,007 Balleza,16884,8682,8202
191,cua,8,8,008 Batopilas,11109,5797,5312
192,cua,8,9,009 Bocoyna,25824,12910,12914
193,cua,8,10,010 Buenaventura,19198,9890,9308
194,cua,8,11,011 Camargo,46386,23079,23307
195,cua,8,12,012 Carichí,8188,4252,3936
196,cua,8,13,013 Casas Grandes,10394,5418,4976
197,cua,8,14,014 Coronado,2562,1345,1217
198,cua,8,15,015 Coyame,2114,1134,980
199,cua,8,16,016 Cruz,3844,1945,1899
200,cua,8,17,017 Cuauhtémoc,120140,59106,61034
201,cua,8,18,018 Cusihuiriachi,6198,3216,2982
202,cua,8,19,019 Chihuahua,627662,305554,322108
203,cua,8,20,020 Chínipas,7233,3813,3420
204,cua,8,21,021 Delicias,110876,54613,56263
205,cua,8,22,022 Dr. Belisario Domínguez,4648,2406,2242
206,cua,8,23,023 Galeana,3649,1822,1827
207,cua,8,24,024 Santa Isabel,5289,2744,2545
208,cua,8,25,025 Gómez Farías,9506,4764,4742
209,cua,8,26,026 Gran Morelos,4752,2415,2337
210,cua,8,27,027 Guachochi,38770,19709,19061
211,cua,8,28,028 Guadalupe,9611,4982,4629
212,cua,8,29,029 Guadalupe y Calvo,42593,21717,20876
213,cua,8,30,030 Guazapares,9078,4600,4478
214,cua,8,31,031 Guerrero,40209,20559,19650
215,cua,8,32,032 Hidalgo del Parral,98385,47828,50557
216,cua,8,33,033 Huejotitán,1446,737,709
217,cua,8,34,034 Ignacio Zaragoza,7911,4067,3844
218,cua,8,35,035 Janos,10794,5626,5168
219,cua,8,36,036 Jiménez,39746,19997,19749
220,cua,8,37,037 Juárez,1011786,505774,506012
221,cua,8,38,038 Julimes,5335,2753,2582
222,cua,8,39,039 López,4646,2446,2200
223,cua,8,40,040 Madera,34564,17631,16933
224,cua,8,41,041 Maguarichi,2095,1099,996
225,cua,8,42,042 Manuel Benavides,2339,1247,1092
226,cua,8,43,043 Matachí,3547,1789,1758
227,cua,8,44,044 Matamoros,4489,2332,2157
228,cua,8,45,045 Meoqui,38152,19137,19015
229,cua,8,46,046 Morelos,8167,4187,3980
230,cua,8,47,047 Moris,5132,2724,2408
231,cua,8,48,048 Namiquipa,24711,12432,12279
232,cua,8,49,049 Nonoava,3246,1669,1577
233,cua,8,50,050 Nuevo Casas Grandes,54061,26593,27468
234,cua,8,51,051 Ocampo,7499,3932,3567
235,cua,8,52,052 Ojinaga,23581,11910,11671
236,cua,8,53,053 Praxedis G. Guerrero,8986,4608,4378
237,cua,8,54,054 Riva Palacio,9300,4791,4509
238,cua,8,55,055 Rosales,14809,7504,7305
239,cua,8,56,056 Rosario,3130,1581,1549
240,cua,8,57,057 San Francisco de Borja,2635,1357,1278
241,cua,8,58,058 San Francisco de Conchos,2991,1540,1451
242,cua,8,59,059 San Francisco del Oro,6918,3490,3428
243,cua,8,60,060 Santa Bárbara,12699,6324,6375
244,cua,8,61,061 Satevó,5907,3113,2794
245,cua,8,62,062 Saucillo,31048,15339,15709
246,cua,8,63,063 Temósachi,7409,3861,3548
247,cua,8,64,064 Tule,2566,1337,1229
248,cua,8,65,065 Urique,19271,9871,9400
249,cua,8,66,066 Uruachi,8587,4421,4166
250,cua,8,67,067 Valle de Zaragoza,6123,3171,2952
251,df,9,0,Total Entidad,8489007,4075902,4413105
252,df,9,2,002 Azcapotzalco,455131,218769,236362
253,df,9,3,003 Coyoacán,653489,308752,344737
254,df,9,4,004 Cuajimalpa de Morelos,136873,66258,70615
255,df,9,5,005 Gustavo A. Madero,1256913,608453,648460
256,df,9,6,006 Iztacalco,418982,201270,217712
257,df,9,7,007 Iztapalapa,1696609,832343,864266
258,df,9,8,008 Magdalena Contreras,211898,101991,109907
259,df,9,9,009 Milpa Alta,81102,40435,40667
260,df,9,10,010 Álvaro Obregón,676930,324362,352568
261,df,9,11,011 Tláhuac,255891,125763,130128
262,df,9,12,012 Tlalpan,552516,267428,285088
263,df,9,13,013 Xochimilco,332314,163572,168742
264,df,9,14,014 Benito Juárez,369956,164374,205582
265,df,9,15,015 Cuauhtémoc,540382,254172,286210
266,df,9,16,016 Miguel Hidalgo,364398,166337,198061
267,df,9,17,017 Venustiano Carranza,485623,231623,254000
268,dgo,10,0,Total Entidad,1431748,709268,722480
269,dgo,10,1,001 Canatlán,34854,17511,17343
270,dgo,10,2,002 Canelas,4555,2303,2252
271,dgo,10,3,003 Coneto de Comonfort,5403,2759,2644
272,dgo,10,4,004 Cuencamé,34660,17521,17139
273,dgo,10,5,005 Durango,464566,226184,238382
274,dgo,10,6,006 General Simón Bolívar,12427,6405,6022
275,dgo,10,7,007 Gómez Palacio,257042,127052,129990
276,dgo,10,8,008 Guadalupe Victoria,32690,16140,16550
277,dgo,10,9,009 Guanaceví,11447,5822,5625
278,dgo,10,10,010 Hidalgo,5203,2637,2566
279,dgo,10,11,011 Indé,6760,3423,3337
280,dgo,10,12,012 Lerdo,105533,52358,53175
281,dgo,10,13,013 Mapimí,24024,12073,11951
282,dgo,10,14,014 Mezquital,26817,13243,13574
283,dgo,10,15,015 Nazas,12864,6480,6384
284,dgo,10,16,016 Nombre de Dios,19318,9666,9652
285,dgo,10,17,017 Ocampo,11579,5922,5657
286,dgo,10,18,018 Oro,13516,6600,6916
287,dgo,10,19,019 Otáez,5518,2794,2724
288,dgo,10,20,020 Pánuco de Coronado,14520,7278,7242
289,dgo,10,21,021 Peñón Blanco,11272,5756,5516
290,dgo,10,22,022 Poanas,26414,13328,13086
291,dgo,10,23,023 Pueblo Nuevo,43909,22011,21898
292,dgo,10,24,024 Rodeo,13547,6784,6763
293,dgo,10,25,025 San Bernardo,4883,2568,2315
294,dgo,10,26,026 San Dimas,23184,11858,11326
295,dgo,10,27,027 San Juan de Guadalupe,7262,3600,3662
296,dgo,10,28,028 San Juan del Río,14212,7273,6939
297,dgo,10,29,029 San Luis del Cordero,2364,1155,1209
298,dgo,10,30,030 San Pedro del Gallo,2144,1100,1044
299,dgo,10,31,031 Santa Clara,8050,4024,4026
300,dgo,10,32,032 Santiago Papasquiaro,42993,21531,21462
301,dgo,10,33,033 Súchil,7512,3730,3782
302,dgo,10,34,034 Tamazula,27361,14384,12977
303,dgo,10,35,035 Tepehuanes,13588,6488,7100
304,dgo,10,36,036 Tlahualilo,22924,11308,11616
305,dgo,10,37,037 Topia,8808,4485,4323
306,dgo,10,38,038 Vicente Guerrero,20126,9899,10227
307,dgo,10,39,039 Nuevo Ideal,27899,13815,14084
308,gua,11,0,Total Entidad,4406568,2139104,2267464
309,gua,11,1,001 Abasolo,74768,36057,38711
310,gua,11,2,002 Acámbaro,112485,53370,59115
311,gua,11,3,003 Allende,118769,57922,60847
312,gua,11,4,004 Apaseo el Alto,54364,26554,27810
313,gua,11,5,005 Apaseo el Grande,62848,30574,32274
314,gua,11,6,006 Atarjea,5282,2679,2603
315,gua,11,7,007 Celaya,354473,171428,183045
316,gua,11,8,008 Manuel Doblado,37776,18032,19744
317,gua,11,9,009 Comonfort,61986,29749,32237
318,gua,11,10,010 Coroneo,9466,4649,4817
319,gua,11,11,011 Cortazar,80185,38940,41245
320,gua,11,12,012 Cuerámaro,24512,11695,12817
321,gua,11,13,013 Doctor Mora,18660,9089,9571
322,gua,11,14,014 Dolores Hidalgo,118972,57878,61094
323,gua,11,15,015 Guanajuato,128171,62662,65509
324,gua,11,16,016 Huanímaro,19492,9294,10198
325,gua,11,17,017 Irapuato,412639,200030,212609
326,gua,11,18,018 Jaral del Progreso,31070,15036,16034
327,gua,11,19,019 Jerécuaro,53006,25769,27237
328,gua,11,20,020 León,1042132,511142,530990
329,gua,11,21,021 Moroleón,47154,21924,25230
330,gua,11,22,022 Ocampo,20100,9810,10290
331,gua,11,23,023 Pénjamo,141135,67401,73734
332,gua,11,24,024 Pueblo Nuevo,10524,4978,5546
333,gua,11,25,025 Purísima del Rincón,34779,17095,17684
334,gua,11,26,026 Romita,51174,25006,26168
335,gua,11,27,027 Salamanca,221125,107693,113432
336,gua,11,28,028 Salvatierra,97822,46103,51719
337,gua,11,29,029 San Diego de la Unión,32019,15508,16511
338,gua,11,30,030 San Felipe,95050,47050,48000
339,gua,11,31,031 San Francisco del Rincón,97269,47292,49977
340,gua,11,32,032 San José Iturbide,50596,24486,26110
341,gua,11,33,033 San Luis de la Paz,90441,44102,46339
342,gua,11,34,034 Santa Catarina,4284,2091,2193
343,gua,11,35,035 Santa Cruz de Juventino Rosas,61945,30444,31501
344,gua,11,36,036 Santiago Maravatío,8034,3696,4338
345,gua,11,37,037 Silao,131527,64936,66591
346,gua,11,38,038 Tarandacuao,11949,5626,6323
347,gua,11,39,039 Tarimoro,37291,17514,19777
348,gua,11,40,040 Tierra Blanca,13614,6572,7042
349,gua,11,41,041 Uriangato,49391,23716,25675
350,gua,11,42,042 Valle de Santiago,131460,62674,68786
351,gua,11,43,043 Victoria,17746,8730,9016
352,gua,11,44,044 Villagrán,42653,20648,22005
353,gua,11,45,045 Xichú,11182,5515,5667
354,gua,11,46,046 Yuriria,75248,35945,39303
355,gue,12,0,Total Entidad,2916567,1433417,1483150
356,gue,12,1,001 Acapulco de Juárez,687292,334114,353178
357,gue,12,2,002 Ahuacuotzingo,22200,10856,11344
358,gue,12,3,003 Ajuchitlán del Progreso,38107,18458,19649
359,gue,12,4,004 Alcozauca de Guerrero,15502,7681,7821
360,gue,12,5,005 Alpoyeca,5293,2513,2780
361,gue,12,6,006 Apaxtla,13677,6685,6992
362,gue,12,7,007 Arcelia,32793,16190,16603
363,gue,12,8,008 Atenango del Río,8606,4151,4455
364,gue,12,9,009 Atlamajalcingo del Monte,7599,3792,3807
365,gue,12,10,010 Atlixtac,18883,9253,9630
366,gue,12,11,011 Atoyac de Álvarez,62039,30729,31310
367,gue,12,12,012 Ayutla de los Libres,50561,25435,25126
368,gue,12,13,013 Azoyú,32409,16252,16157
369,gue,12,14,014 Benito Juárez,16377,8170,8207
370,gue,12,15,015 Buenavista de Cuéllar,11683,5692,5991
371,gue,12,16,016 Coahuayutla de José María Izazaga,15246,7711,7535
372,gue,12,17,017 Cocula,16333,7911,8422
373,gue,12,18,018 Copala,12814,6363,6451
374,gue,12,19,019 Copalillo,14090,6973,7117
375,gue,12,20,020 Copanatoyac,14126,6900,7226
376,gue,12,21,021 Coyuca de Benítez,67490,33480,34010
377,gue,12,22,022 Coyuca de Catalán,44834,21946,22888
378,gue,12,23,023 Cuajinicuilapa,25057,12483,12574
379,gue,12,24,024 Cualác,6157,3053,3104
380,gue,12,25,025 Cuautepec,13815,7135,6680
381,gue,12,26,026 Cuetzala del Progreso,9653,4756,4897
382,gue,12,27,027 Cutzamala de Pinzón,26672,12856,13816
383,gue,12,28,028 Chilapa de Álvarez,98983,48539,50444
384,gue,12,29,029 Chilpancingo de los Bravo,170368,83363,87005
385,gue,12,30,030 Florencio Villarreal,17319,8706,8613
386,gue,12,31,031 General Canuto A. Neri,8108,3865,4243
387,gue,12,32,032 General Heliodoro Castillo,33096,16799,16297
388,gue,12,33,033 Huamuxtitlán,13148,6294,6854
389,gue,12,34,034 Huitzuco de los Figueroa,37857,18320,19537
390,gue,12,35,035 Iguala de la Independencia,116616,56296,60320
391,gue,12,36,036 Igualapa,8874,4424,4450
392,gue,12,37,037 Ixcateopan de Cuauhtémoc,7188,3398,3790
393,gue,12,38,038 José Azueta,87161,43520,43641
394,gue,12,39,039 Juan R. Escudero,23094,11571,11523
395,gue,12,40,040 Leonardo Bravo,22303,11129,11174
396,gue,12,41,041 Malinaltepec,24926,12421,12505
397,gue,12,42,042 Mártir de Cuilapan,14887,7479,7408
398,gue,12,43,043 Metlatónoc,26886,13154,13732
399,gue,12,44,044 Mochitlán,9904,4924,4980
400,gue,12,45,045 Olinalá,19605,9783,9822
401,gue,12,46,046 Ometepec,44285,21965,22320
402,gue,12,47,047 Pedro Ascencio Alquisiras,7284,3432,3852
403,gue,12,48,048 Petatlán,47630,23905,23725
404,gue,12,49,049 Pilcaya,10408,5115,5293
405,gue,12,50,050 Pungarabato,32546,15780,16766
406,gue,12,51,051 Quechultenango,29927,15025,14902
407,gue,12,52,052 San Luis Acatlán,31308,15777,15531
408,gue,12,53,053 San Marcos,46800,23300,23500
409,gue,12,54,054 San Miguel Totolapan,26830,13405,13425
410,gue,12,55,055 Taxco de Alarcón,95144,46682,48462
411,gue,12,56,056 Tecoanapa,39827,20048,19779
412,gue,12,57,057 Técpan de Galeana,61944,30975,30969
413,gue,12,58,058 Teloloapan,53272,25435,27837
414,gue,12,59,059 Tepecoacuilco de Trujano,33102,16033,17069
415,gue,12,60,060 Tetipac,12649,6310,6339
416,gue,12,61,061 Tixtla de Guerrero,33657,16606,17051
417,gue,12,62,062 Tlacoachistlahuaca,12477,6262,6215
418,gue,12,63,063 Tlacoapa,7645,3637,4008
419,gue,12,64,064 Tlalchapa,13832,6762,7070
420,gue,12,65,065 Tlalixtaquilla de Maldonado,6681,3247,3434
421,gue,12,66,066 Tlapa de Comonfort,50040,24300,25740
422,gue,12,67,067 Tlapehuala,20851,10092,10759
423,gue,12,68,068 Unión de Isidoro Montes de Oca,27515,14020,13495
424,gue,12,69,069 Xalpatláhuac,10546,5233,5313
425,gue,12,70,070 Xochihuehuetlán,7183,3246,3937
426,gue,12,71,071 Xochistlahuaca,18513,9182,9331
427,gue,12,72,072 Zapotitlán Tablas,11222,5553,5669
428,gue,12,73,073 Zirándaro,22382,11229,11153
429,gue,12,74,074 Zitlala,17786,8826,8960
430,gue,12,75,075 Eduardo Neri,37633,18623,19010
431,gue,12,76,076 Acatepec,16017,7889,8128
432,hgo,13,0,Total Entidad,2112473,1042566,1069907
433,hgo,13,1,001 Acatlán,19547,9799,9748
434,hgo,13,2,002 Acaxochitlán,33208,16348,16860
435,hgo,13,3,003 Actopan,44223,21177,23046
436,hgo,13,4,004 Agua Blanca de Iturbide,8959,4480,4479
437,hgo,13,5,005 Ajacuba,13994,7040,6954
438,hgo,13,6,006 Alfajayucan,16522,8501,8021
439,hgo,13,7,007 Almoloya,10340,5184,5156
440,hgo,13,8,008 Apan,37170,18139,19031
441,hgo,13,9,009 Arenal,14046,6943,7103
442,hgo,13,10,010 Atitalaquia,19794,9926,9868
443,hgo,13,11,011 Atlapexco,17101,8426,8675
444,hgo,13,12,012 Atotonilco el Grande,26213,12814,13399
445,hgo,13,13,013 Atotonilco de Tula,22607,11392,11215
446,hgo,13,14,014 Calnali,16129,7940,8189
447,hgo,13,15,015 Cardonal,18481,9342,9139
448,hgo,13,16,016 Cuautepec de Hinojosa,43906,21694,22212
449,hgo,13,17,017 Chapantongo,12335,6317,6018
450,hgo,13,18,018 Chapulhuacán,20555,10668,9887
451,hgo,13,19,019 Chilcuautla,14744,7520,7224
452,hgo,13,20,020 Eloxochitlán,2784,1363,1421
453,hgo,13,21,021 Emiliano Zapata,12208,5971,6237
454,hgo,13,22,022 Epazoyucan,10146,5023,5123
455,hgo,13,23,023 Francisco I. Madero,28125,13975,14150
456,hgo,13,24,024 Huasca de Ocampo,15024,7430,7594
457,hgo,13,25,025 Huautla,24780,12056,12724
458,hgo,13,26,026 Huazalingo,10148,5045,5103
459,hgo,13,27,027 Huehuetla,22748,11482,11266
460,hgo,13,28,028 Huejutla de Reyes,97387,48274,49113
461,hgo,13,29,029 Huichapan,37355,18447,18908
462,hgo,13,30,030 Ixmiquilpan,73838,35948,37890
463,hgo,13,31,031 Jacala de Ledezma,12746,6258,6488
464,hgo,13,32,032 Jaltocán,8419,4185,4234
465,hgo,13,33,033 Juárez Hidalgo,2981,1511,1470
466,hgo,13,34,034 Lolotla,9463,4682,4781
467,hgo,13,35,035 Metepec,10107,5025,5082
468,hgo,13,36,036 San Agustín Metzquititlán,8445,4052,4393
469,hgo,13,37,037 Metztitlán,21595,10615,10980
470,hgo,13,38,038 Mineral del Chico,6728,3346,3382
471,hgo,13,39,039 Mineral del Monte,13340,6395,6945
472,hgo,13,40,040 Misión,11455,5837,5618
473,hgo,13,41,041 Mixquiahuala de Juárez,35200,17391,17809
474,hgo,13,42,042 Molango de Escamilla,10232,5089,5143
475,hgo,13,43,043 Nicolás Flores,7448,3771,3677
476,hgo,13,44,044 Nopala de Villagrán,14874,7559,7315
477,hgo,13,45,045 Omitlán de Juárez,6498,3294,3204
478,hgo,13,46,046 San Felipe Orizatlán,38020,19340,18680
479,hgo,13,47,047 Pacula,6142,3044,3098
480,hgo,13,48,048 Pachuca de Soto,220488,105788,114700
481,hgo,13,49,049 Pisaflores,15789,8184,7605
482,hgo,13,50,050 Progreso de Obregón,19267,9374,9893
483,hgo,13,51,051 Mineral de la Reforma,28548,13907,14641
484,hgo,13,52,052 San Agustín Tlaxiaca,21571,10789,10782
485,hgo,13,53,053 San Bartolo Tutotepec,18289,9290,8999
486,hgo,13,54,054 San Salvador,28799,14241,14558
487,hgo,13,55,055 Santiago de Anaya,13605,6811,6794
488,hgo,13,56,056 Santiago Tulantepec de Lugo Guerrero,22738,11107,11631
489,hgo,13,57,057 Singuilucan,12865,6475,6390
490,hgo,13,58,058 Tasquillo,16926,8302,8624
491,hgo,13,59,059 Tecozautla,28529,14026,14503
492,hgo,13,60,060 Tenango de Doria,16424,8242,8182
493,hgo,13,61,061 Tepeapulco,48241,23587,24654
494,hgo,13,62,062 Tepehuacán de Guerrero,24221,12497,11724
495,hgo,13,63,063 Tepeji del Río de Ocampo,61950,30958,30992
496,hgo,13,64,064 Tepetitlán,8635,4257,4378
497,hgo,13,65,065 Tetepango,8805,4419,4386
498,hgo,13,66,066 Villa de Tezontepec,8817,4425,4392
499,hgo,13,67,067 Tezontepec de Aldama,35722,17932,17790
500,hgo,13,68,068 Tianguistengo,14091,6956,7135
501,hgo,13,69,069 Tizayuca,39357,19513,19844
502,hgo,13,70,070 Tlahuelilpan,13400,6620,6780
503,hgo,13,71,071 Tlahuiltepa,11245,5704,5541
504,hgo,13,72,072 Tlanalapa,9648,4782,4866
505,hgo,13,73,073 Tlanchinol,31193,15734,15459
506,hgo,13,74,074 Tlaxcoapan,21159,10530,10629
507,hgo,13,75,075 Tolcayuca,9997,4943,5054
508,hgo,13,76,076 Tula de Allende,82333,40654,41679
509,hgo,13,77,077 Tulancingo de Bravo,110140,52692,57448
510,hgo,13,78,078 Xochiatipan,15894,7774,8120
511,hgo,13,79,079 Xochicoatlán,7846,3970,3876
512,hgo,13,80,080 Yahualica,19889,9809,10080
513,hgo,13,81,081 Zacualtipán de Angeles,22785,11030,11755
514,hgo,13,82,082 Zapotlán de Juárez,13597,6616,6981
515,hgo,13,83,083 Zempoala,23148,11618,11530
516,hgo,13,84,084 Zimapán,38412,18952,19460
517,jal,14,0,Total Entidad,5991176,2923921,3067255
518,jal,14,1,001 Acatic,17906,8560,9346
519,jal,14,2,002 Acatlán de Juárez,18335,9101,9234
520,jal,14,3,003 Ahualulco de Mercado,19993,9911,10082
521,jal,14,4,004 Amacueca,5068,2438,2630
522,jal,14,5,005 Amatitán,11317,5665,5652
523,jal,14,6,006 Ameca,56343,27667,28676
524,jal,14,7,007 Antonio Escobedo,8948,4524,4424
525,jal,14,8,008 Arandas,70901,33741,37160
526,jal,14,9,009 Arenal,13574,6704,6870
527,jal,14,10,010 Atemajac de Brizuela,5695,2797,2898
528,jal,14,11,011 Atengo,5289,2645,2644
529,jal,14,12,012 Atenguillo,4444,2135,2309
530,jal,14,13,013 Atotonilco el Alto,49638,24052,25586
531,jal,14,14,014 Atoyac,9263,4506,4757
532,jal,14,15,015 Autlán de Navarro,47694,23412,24282
533,jal,14,16,016 Ayotlán,33851,16445,17406
534,jal,14,17,017 Ayutla,13472,6737,6735
535,jal,14,18,018 Barca,57338,27588,29750
536,jal,14,19,019 Bolaños,5032,2521,2511
537,jal,14,20,020 Cabo Corrientes,8744,4583,4161
538,jal,14,21,021 Casimiro Castillo,20909,10465,10444
539,jal,14,22,022 Cihuatlán,30955,15692,15263
540,jal,14,23,023 Ciudad Guzmán,83305,40051,43254
541,jal,14,24,024 Cocula,25602,12433,13169
542,jal,14,25,025 Colotlán,16011,7715,8296
543,jal,14,26,026 Concepción de Buenos Aires,5394,2675,2719
544,jal,14,27,027 Cuautitlán de García Barragán,15532,7925,7607
545,jal,14,28,028 Cuautla,2479,1153,1326
546,jal,14,29,029 Cuquío,17034,8259,8775
547,jal,14,30,030 Chapala,40252,19767,20485
548,jal,14,31,031 Chimaltitán,3816,1892,1924
549,jal,14,32,032 Chiquilistlán,5144,2548,2596
550,jal,14,33,033 Degollado,21018,10025,10993
551,jal,14,34,034 Ejutla,2265,1098,1167
552,jal,14,35,035 Encarnación de Díaz,45525,22055,23470
553,jal,14,36,036 Etzatlán,16927,8353,8574
554,jal,14,37,037 Grullo,20488,9996,10492
555,jal,14,38,038 Guachinango,4864,2474,2390
556,jal,14,39,039 Guadalajara,1633216,784733,848483
557,jal,14,40,040 Hostotipaquillo,8479,4322,4157
558,jal,14,41,041 Huejúcar,6698,3184,3514
559,jal,14,42,042 Huejuquilla el Alto,8930,4218,4712
560,jal,14,43,043 Huerta,22432,11319,11113
561,jal,14,44,044 Ixtlahuacán de los Membrillos,20598,10285,10313
562,jal,14,45,045 Ixtlahuacán del Río,19248,9293,9955
563,jal,14,46,046 Jalostotitlán,26297,12497,13800
564,jal,14,47,047 Jamay,18685,9251,9434
565,jal,14,48,048 Jesús María,20356,9584,10772
566,jal,14,49,049 Jilotlán de los Dolores,10852,5595,5257
567,jal,14,50,050 Jocotepec,34491,17004,17487
568,jal,14,51,051 Juanacatlán,11513,5799,5714
569,jal,14,52,052 Juchitlán,5921,2816,3105
570,jal,14,53,053 Lagos de Moreno,124972,60690,64282
571,jal,14,54,054 Limón,5974,2963,3011
572,jal,14,55,055 Magdalena,17972,8781,9191
573,jal,14,56,056 Manuel M. Dieguez,2882,1449,1433
574,jal,14,57,057 Manzanilla de la Paz,3412,1609,1803
575,jal,14,58,058 Mascota,14045,6927,7118
576,jal,14,59,059 Mazamitla,10672,5096,5576
577,jal,14,60,060 Mexticacán,7328,3341,3987
578,jal,14,61,061 Mezquitic,13499,6630,6869
579,jal,14,62,062 Mixtlán,3779,1847,1932
580,jal,14,63,063 Ocotlán,78128,38072,40056
581,jal,14,64,064 Ojuelos de Jalisco,25743,12674,13069
582,jal,14,65,065 Pihuamo,15217,7552,7665
583,jal,14,66,066 Poncitlán,36893,18131,18762
584,jal,14,67,067 Puerto Vallarta,149876,75071,74805
585,jal,14,68,068 Villa Purificación,12014,6017,5997
586,jal,14,69,069 Quitupan,11485,5297,6188
587,jal,14,70,070 Salto,70085,35406,34679
588,jal,14,71,071 San Cristóbal de la Barranca,4638,2289,2349
589,jal,14,72,072 San Diego de Alejandría,6389,2992,3397
590,jal,14,73,073 San Juan de los Lagos,53366,25970,27396
591,jal,14,74,074 San Julián,13700,6266,7434
592,jal,14,75,075 San Marcos,3562,1823,1739
593,jal,14,76,076 San Martín de Bolaños,3970,1996,1974
594,jal,14,77,077 San Martín Hidalgo,27269,13199,14070
595,jal,14,78,078 San Miguel el Alto,27237,12753,14484
596,jal,14,79,079 Gómez Farías,12408,5896,6512
597,jal,14,80,080 San Sebastián del Oeste,7076,3632,3444
598,jal,14,81,081 Santa María de los Ángeles,4184,1976,2208
599,jal,14,82,082 Sayula,30844,15122,15722
600,jal,14,83,083 Tala,50928,25228,25700
601,jal,14,84,084 Talpa de Allende,14276,7147,7129
602,jal,14,85,085 Tamazula de Gordiano,40315,19463,20852
603,jal,14,86,086 Tapalpa,14099,7001,7098
604,jal,14,87,087 Tecalitlán,17564,8609,8955
605,jal,14,88,088 Tecolotlán,15878,7904,7974
606,jal,14,89,089 Techaluta de Montenegro,3190,1565,1625
607,jal,14,90,090 Tenamaxtlán,7195,3506,3689
608,jal,14,91,091 Teocaltiche,37164,17719,19445
609,jal,14,92,092 Teocuitatlán de Corona,12152,5815,6337
610,jal,14,93,093 Tepatitlán de Morelos,109300,52746,56554
611,jal,14,94,094 Tequila,33155,16424,16731
612,jal,14,95,095 Teuchitlán,8133,3909,4224
613,jal,14,96,096 Tizapán el Alto,19963,9805,10158
614,jal,14,97,097 Tlajomulco de Zúñiga,100797,50196,50601
615,jal,14,98,098 Tlaquepaque,449238,223025,226213
616,jal,14,99,099 Tolimán,9370,4615,4755
617,jal,14,100,100 Tomatlán,33872,17479,16393
618,jal,14,101,101 Tonalá,271857,137597,134260
619,jal,14,102,102 Tonaya,6749,3308,3441
620,jal,14,103,103 Tonila,7386,3592,3794
621,jal,14,104,104 Totatiche,6125,2941,3184
622,jal,14,105,105 Tototlán,19819,9619,10200
623,jal,14,106,106 Tuxcacuesco,4027,2014,2013
624,jal,14,107,107 Tuxcueca,5509,2675,2834
625,jal,14,108,108 Tuxpan,33652,16379,17273
626,jal,14,109,109 Unión de San Antonio,15172,7146,8026
627,jal,14,110,110 Unión de Tula,14594,7057,7537
628,jal,14,111,111 Valle de Guadalupe,5663,2662,3001
629,jal,14,112,112 Valle de Juárez,5646,2662,2984
630,jal,14,113,113 San Gabriel,14303,6994,7309
631,jal,14,114,114 Villa Corona,16055,7775,8280
632,jal,14,115,115 Villa Guerrero,5766,2740,3026
633,jal,14,116,116 Villa Hidalgo,13715,6640,7075
634,jal,14,117,117 Cañadas de Obregón,4907,2272,2635
635,jal,14,118,118 Yahualica de González Gallo,23539,10889,12650
636,jal,14,119,119 Zacoalco de Torres,25836,12545,13291
637,jal,14,120,120 Zapopan,925113,452764,472349
638,jal,14,121,121 Zapotiltic,28961,14033,14928
639,jal,14,122,122 Zapotitlán de Vadillo,6516,3210,3306
640,jal,14,123,123 Zapotlán del Rey,15016,7432,7584
641,jal,14,124,124 Zapotlanejo,51961,25144,26817
642,mex,15,0,Total Entidad,11707964,5776054,5931910
643,mex,15,1,001 Acambay,52662,26265,26397
644,mex,15,2,002 Acolman,54468,27029,27439
645,mex,15,3,003 Aculco,34378,17334,17044
646,mex,15,4,004 Almoloya de Alquisiras,13667,6672,6995
647,mex,15,5,005 Almoloya de Juárez,96662,48841,47821
648,mex,15,6,006 Almoloya del Río,7729,3698,4031
649,mex,15,7,007 Amanalco,18885,9533,9352
650,mex,15,8,008 Amatepec,28807,14483,14324
651,mex,15,9,009 Amecameca,41671,20291,21380
652,mex,15,10,010 Apaxco,21134,10547,10587
653,mex,15,11,011 Atenco,27988,13920,14068
654,mex,15,12,012 Atizapán,7147,3512,3635
655,mex,15,13,013 Atizapán de Zaragoza,427444,209842,217602
656,mex,15,14,014 Atlacomulco,65018,31565,33453
657,mex,15,15,015 Atlautla,22634,11249,11385
658,mex,15,16,016 Axapusco,17848,9082,8766
659,mex,15,17,017 Ayapango,4858,2421,2437
660,mex,15,18,018 Calimaya,31902,15735,16167
661,mex,15,19,019 Capulhuac,25900,12779,13121
662,mex,15,20,020 Coacalco de Berriozábal,204674,100193,104481
663,mex,15,21,021 Coatepec Harinas,30408,14977,15431
664,mex,15,22,022 Cocotitlán,9290,4656,4634
665,mex,15,23,023 Coyotepec,30619,15264,15355
666,mex,15,24,024 Cuautitlán,57373,28356,29017
667,mex,15,25,025 Chalco,175521,87833,87688
668,mex,15,26,026 Chapa de Mota,20939,10453,10486
669,mex,15,27,027 Chapultepec,5163,2506,2657
670,mex,15,28,028 Chiautla,16602,8142,8460
671,mex,15,29,029 Chicoloapan,71351,35467,35884
672,mex,15,30,030 Chiconcuac,15448,7603,7845
673,mex,15,31,031 Chimalhuacán,412014,206089,205925
674,mex,15,32,032 Donato Guerra,24787,12454,12333
675,mex,15,33,033 Ecatepec,1457124,720752,736372
676,mex,15,34,034 Ecatzingo,6949,3507,3442
677,mex,15,35,035 Huehuetoca,32718,16282,16436
678,mex,15,36,036 Hueypoxtla,31124,15569,15555
679,mex,15,37,037 Huixquilucan,168221,79996,88225
680,mex,15,38,038 Isidro Fabela,6606,3346,3260
681,mex,15,39,039 Ixtapaluca,187690,93530,94160
682,mex,15,40,040 Ixtapan de la Sal,24889,11967,12922
683,mex,15,41,041 Ixtapan del Oro,5726,2931,2795
684,mex,15,42,042 Ixtlahuaca,107628,52711,54917
685,mex,15,43,043 Xalatlaco,17601,8673,8928
686,mex,15,44,044 Jaltenco,26238,12957,13281
687,mex,15,45,045 Jilotepec,61802,31045,30757
688,mex,15,46,046 Jilotzingo,12412,6231,6181
689,mex,15,47,047 Jiquipilco,51447,25378,26069
690,mex,15,48,048 Jocotitlán,43994,21808,22186
691,mex,15,49,049 Joquicingo,10223,5049,5174
692,mex,15,50,050 Juchitepec,17487,8613,8874
693,mex,15,51,051 Lerma,81192,40409,40783
694,mex,15,52,052 Malinalco,20157,9997,10160
695,mex,15,53,053 Melchor Ocampo,33455,16613,16842
696,mex,15,54,054 Metepec,178096,86863,91233
697,mex,15,55,055 Mexicaltzingo,8662,4221,4441
698,mex,15,56,056 Morelos,24016,11783,12233
699,mex,15,57,057 Naucalpan de Juárez,839723,409423,430300
700,mex,15,58,058 Nezahualcóyotl,1233868,604881,628987
701,mex,15,59,059 Nextlalpan,15053,7427,7626
702,mex,15,60,060 Nicolás Romero,237064,117973,119091
703,mex,15,61,061 Nopaltepec,6492,3293,3199
704,mex,15,62,062 Ocoyoacac,43670,21614,22056
705,mex,15,63,063 Ocuilan,22869,11520,11349
706,mex,15,64,064 Oro,29466,14519,14947
707,mex,15,65,065 Otumba,25415,12811,12604
708,mex,15,66,066 Otzoloapan,4687,2408,2279
709,mex,15,67,067 Otzolotepec,49264,24226,25038
710,mex,15,68,068 Ozumba,21424,10447,10977
711,mex,15,69,069 Papalotla,2998,1453,1545
712,mex,15,70,070 Paz,178538,88597,89941
713,mex,15,71,071 Polotitlán,10525,5294,5231
714,mex,15,72,072 Rayón,8300,4118,4182
715,mex,15,73,073 San Antonio la Isla,9118,4571,4547
716,mex,15,74,074 San Felipe del Progreso,155978,77440,78538
717,mex,15,75,075 San Martín de las Pirámides,16881,8468,8413
718,mex,15,76,076 San Mateo Atenco,54089,26751,27338
719,mex,15,77,077 San Simón de Guerrero,4504,2251,2253
720,mex,15,78,078 Santo Tomás,8257,4144,4113
721,mex,15,79,079 Soyaniquilpan de Juárez,8370,4278,4092
722,mex,15,80,080 Sultepec,24757,12185,12572
723,mex,15,81,081 Tecámac,148432,73396,75036
724,mex,15,82,082 Tejupilco,84897,42074,42823
725,mex,15,83,083 Temamatla,7720,4120,3600
726,mex,15,84,084 Temascalapa,24440,12286,12154
727,mex,15,85,085 Temascalcingo,59140,29312,29828
728,mex,15,86,086 Temascaltepec,26643,13457,13186
729,mex,15,87,087 Temoaya,60851,29901,30950
730,mex,15,88,088 Tenancingo,64753,32081,32672
731,mex,15,89,089 Tenango del Aire,7282,3575,3707
732,mex,15,90,090 Tenango del Valle,54789,26945,27844
733,mex,15,91,091 Teoloyucan,54454,27095,27359
734,mex,15,92,092 Teotihuacán,39183,19625,19558
735,mex,15,93,093 Tepetlaoxtoc,19380,9725,9655
736,mex,15,94,094 Tepetlixpa,15181,7565,7616
737,mex,15,95,095 Tepotzotlán,54419,26913,27506
738,mex,15,96,096 Tequixquiac,24766,12343,12423
739,mex,15,97,097 Texcaltitlán,13970,6914,7056
740,mex,15,98,098 Texcalyacac,3744,1829,1915
741,mex,15,99,099 Texcoco,173106,86820,86286
742,mex,15,100,100 Tezoyuca,16338,8129,8209
743,mex,15,101,101 Tianguistenco,51149,25030,26119
744,mex,15,102,102 Timilpan,13871,6943,6928
745,mex,15,103,103 Tlalmanalco,38396,18926,19470
746,mex,15,104,104 Tlalnepantla de Baz,713143,349170,363973
747,mex,15,105,105 Tlatlaya,33170,16277,16893
748,mex,15,106,106 Toluca,564476,273723,290753
749,mex,15,107,107 Tonatico,9966,4702,5264
750,mex,15,108,108 Tultepec,75996,37606,38390
751,mex,15,109,109 Tultitlán,361434,178263,183171
752,mex,15,110,110 Valle de Bravo,47502,23564,23938
753,mex,15,111,111 Villa de Allende,37105,18453,18652
754,mex,15,112,112 Villa del Carbón,30726,15523,15203
755,mex,15,113,113 Villa Guerrero,43283,21354,21929
756,mex,15,114,114 Villa Victoria,63978,32113,31865
757,mex,15,115,115 Xonacatlán,36141,17908,18233
758,mex,15,116,116 Zacazonapan,3161,1634,1527
759,mex,15,117,117 Zacualpan,14115,6881,7234
760,mex,15,118,118 Zinacantepec,105566,52487,53079
761,mex,15,119,119 Zumpahuacán,13178,6440,6738
762,mex,15,120,120 Zumpango,91642,45919,45723
763,mex,15,121,121 Cuautitlán Izcalli,417647,205580,212067
764,mex,15,122,122 Valle de Chalco Solidaridad,287073,144339,142734
765,mic,16,0,Total Entidad,3870604,1884105,1986499
766,mic,16,1,001 Acuitzio,10109,4806,5303
767,mic,16,2,002 Aguililla,20640,10345,10295
768,mic,16,3,003 Álvaro Obregón,19633,9482,10151
769,mic,16,4,004 Angamacutiro,16062,7833,8229
770,mic,16,5,005 Angangueo,9705,4755,4950
771,mic,16,6,006 Apatzingán,114837,56885,57952
772,mic,16,7,007 Aporo,2611,1273,1338
773,mic,16,8,008 Aquila,19411,9782,9629
774,mic,16,9,009 Ario,31254,15185,16069
775,mic,16,10,010 Arteaga,23921,11969,11952
776,mic,16,11,011 Briseñas,9831,4720,5111
777,mic,16,12,012 Buenavista,38625,19223,19402
778,mic,16,13,013 Carácuaro,10459,5280,5179
779,mic,16,14,014 Coahuayana,13369,6799,6570
780,mic,16,15,015 Coalcomán de Vázquez Pallares,20786,10484,10302
781,mic,16,16,016 Coeneo,24810,11355,13455
782,mic,16,17,017 Contepec,28257,14189,14068
783,mic,16,18,018 Copándaro,9677,4673,5004
784,mic,16,19,019 Cotija,22171,10524,11647
785,mic,16,20,020 Cuitzeo,25609,12222,13387
786,mic,16,21,021 Charapan,12003,5744,6259
787,mic,16,22,022 Charo,17908,8885,9023
788,mic,16,23,023 Chavinda,11103,5129,5974
789,mic,16,24,024 Cherán,16259,7960,8299
790,mic,16,25,025 Chilchota,29233,14202,15031
791,mic,16,26,026 Chinicuila,7380,3853,3527
792,mic,16,27,027 Chucándiro,8198,3941,4257
793,mic,16,28,028 Churintzio,8263,3781,4482
794,mic,16,29,029 Churumuco,15006,7542,7464
795,mic,16,30,030 Ecuandureo,16582,7797,8785
796,mic,16,31,031 Epitacio Huerta,15400,7726,7674
797,mic,16,32,032 Erongarícuaro,13357,6532,6825
798,mic,16,33,033 Gabriel Zamora,19074,9540,9534
799,mic,16,34,034 Hidalgo,102638,49599,53039
800,mic,16,35,035 Huacana,34716,17221,17495
801,mic,16,36,036 Huandacareo,12022,5566,6456
802,mic,16,37,037 Huaniqueo,10872,4938,5934
803,mic,16,38,038 Huetamo,46161,22326,23835
804,mic,16,39,039 Huiramba,6616,3261,3355
805,mic,16,40,040 Indaparapeo,16520,8129,8391
806,mic,16,41,041 Irimbo,12591,6068,6523
807,mic,16,42,042 Ixtlán,14959,7184,7775
808,mic,16,43,043 Jacona,54859,26754,28105
809,mic,16,44,044 Jiménez,15331,7244,8087
810,mic,16,45,045 Jiquilpan,37122,17652,19470
811,mic,16,46,046 Juárez,10682,5297,5385
812,mic,16,47,047 Jungapeo,17344,8715,8629
813,mic,16,48,048 Lagunillas,5396,2594,2802
814,mic,16,49,049 Madero,16523,8255,8268
815,mic,16,50,050 Maravatío,65699,32596,33103
816,mic,16,51,051 Marcos Castellanos,11899,5732,6167
817,mic,16,52,052 Lázaro Cárdenas,155366,78067,77299
818,mic,16,53,053 Morelia,578061,279874,298187
819,mic,16,54,054 Morelos,11990,5698,6292
820,mic,16,55,055 Múgica,41149,20455,20694
821,mic,16,56,056 Nahuatzen,22032,10756,11276
822,mic,16,57,057 Nocupétaro,7623,3819,3804
823,mic,16,58,058 Nuevo Parangaricutiro,14653,7112,7541
824,mic,16,59,059 Nuevo Urecho,7986,4127,3859
825,mic,16,60,060 Numarán,10239,4912,5327
826,mic,16,61,061 Ocampo,17161,8582,8579
827,mic,16,62,062 Pajacuarán,20390,9706,10684
828,mic,16,63,063 Panindícuaro,18538,8783,9755
829,mic,16,64,064 Parácuaro,23237,11755,11482
830,mic,16,65,065 Paracho,30747,14906,15841
831,mic,16,66,066 Pátzcuaro,75264,36097,39167
832,mic,16,67,067 Penjamillo,21034,9732,11302
833,mic,16,68,068 Peribán,18955,9255,9700
834,mic,16,69,069 Piedad,88581,41889,46692
835,mic,16,70,070 Purépero,15453,7389,8064
836,mic,16,71,071 Puruándiro,74079,35532,38547
837,mic,16,72,072 Queréndaro,14248,7103,7145
838,mic,16,73,073 Quiroga,23846,11583,12263
839,mic,16,74,074 Cojumatlán de Régules,10480,5047,5433
840,mic,16,75,075 Reyes,54039,26112,27927
841,mic,16,76,076 Sahuayo,60034,28778,31256
842,mic,16,77,077 San Lucas,18408,9004,9404
843,mic,16,78,078 Santa Ana Maya,13745,6456,7289
844,mic,16,79,079 Salvador Escalante,38236,18620,19616
845,mic,16,80,080 Senguio,16702,8227,8475
846,mic,16,81,081 Susupuato,8173,4056,4117
847,mic,16,82,082 Tacámbaro,53113,26282,26831
848,mic,16,83,083 Tancítaro,23412,11663,11749
849,mic,16,84,084 Tangamandapio,22151,10812,11339
850,mic,16,85,085 Tangancícuaro,33815,16207,17608
851,mic,16,86,086 Tanhuato,14514,7063,7451
852,mic,16,87,087 Taretan,12777,6328,6449
853,mic,16,88,088 Tarímbaro,36637,17949,18688
854,mic,16,89,089 Tepalcatepec,24678,12485,12193
855,mic,16,90,090 Tingambato,11079,5323,5756
856,mic,16,91,091 Tingüindín,12355,5895,6460
857,mic,16,92,092 Tiquicheo de Nicolás Romero,16355,8060,8295
858,mic,16,93,093 Tlalpujahua,18411,8980,9431
859,mic,16,94,094 Tlazazalca,9294,4422,4872
860,mic,16,95,095 Tocumbo,12237,5956,6281
861,mic,16,96,096 Tumbiscatío,10128,5173,4955
862,mic,16,97,097 Turicato,36112,17685,18427
863,mic,16,98,098 Tuxpan,23511,11662,11849
864,mic,16,99,099 Tuzantla,17628,8788,8840
865,mic,16,100,100 Tzintzuntzan,12408,5882,6526
866,mic,16,101,101 Tzitzio,11498,5822,5676
867,mic,16,102,102 Uruapan,250794,121703,129091
868,mic,16,103,103 Venustiano Carranza,22945,10997,11948
869,mic,16,104,104 Villamar,22066,10634,11432
870,mic,16,105,105 Vista Hermosa,18651,9145,9506
871,mic,16,106,106 Yurécuaro,26487,12890,13597
872,mic,16,107,107 Zacapu,69019,33263,35756
873,mic,16,108,108 Zamora,160079,77116,82963
874,mic,16,109,109 Zináparo,4631,2087,2544
875,mic,16,110,110 Zinapécuaro,48902,23715,25187
876,mic,16,111,111 Ziracuaretiro,11479,5679,5800
877,mic,16,112,112 Zitácuaro,130593,63669,66924
878,mic,16,113,113 José Sixto Verduzco,28903,13791,15112
879,mor,17,0,Total Entidad,1442662,706081,736581
880,mor,17,1,001 Amacuzac,15823,7750,8073
881,mor,17,2,002 Atlatlahucan,12544,6243,6301
882,mor,17,3,003 Axochiapan,28908,14289,14619
883,mor,17,4,004 Ayala,64821,31784,33037
884,mor,17,5,005 Coatlán del Río,9235,4577,4658
885,mor,17,6,006 Cuautla,142446,68702,73744
886,mor,17,7,007 Cuernavaca,316782,152195,164587
887,mor,17,8,008 Emiliano Zapata,49773,24625,25148
888,mor,17,9,009 Huitzilac,13589,6772,6817
889,mor,17,10,010 Jantetelco,13000,6448,6552
890,mor,17,11,011 Jiutepec,150625,73512,77113
891,mor,17,12,012 Jojutla,51800,25302,26498
892,mor,17,13,013 Jonacatepec,13164,6459,6705
893,mor,17,14,014 Mazatepec,8071,4013,4058
894,mor,17,15,015 Miacatlán,22333,11173,11160
895,mor,17,16,016 Ocuituco,14550,7323,7227
896,mor,17,17,017 Puente de Ixtla,51099,25171,25928
897,mor,17,18,018 Temixco,87967,43144,44823
898,mor,17,19,019 Tepalcingo,23329,11689,11640
899,mor,17,20,020 Tepoztlán,26503,13323,13180
900,mor,17,21,021 Tetecala,6843,3450,3393
901,mor,17,22,022 Tetela del Volcán,15673,7858,7815
902,mor,17,23,023 Tlalnepantla,4948,2466,2482
903,mor,17,24,024 Tlaltizapán,43401,21464,21937
904,mor,17,25,025 Tlaquiltenango,29843,14843,15000
905,mor,17,26,026 Tlayacapan,11864,5959,5905
906,mor,17,27,027 Totolapan,8201,4119,4082
907,mor,17,28,028 Xochitepec,40657,20252,20405
908,mor,17,29,029 Yautepec,79108,39011,40097
909,mor,17,30,030 Yecapixtla,33578,16707,16871
910,mor,17,31,031 Zacatepec de Hidalgo,32719,15900,16819
911,mor,17,32,032 Zacualpan de Amilpas,7569,3793,3776
912,mor,17,33,033 Temoac,11896,5765,6131
913,nay,18,0,Total Entidad,896702,448629,448073
914,nay,18,1,001 Acaponeta,37349,18711,18638
915,nay,18,2,002 Ahuacatlán,16128,8162,7966
916,nay,18,3,003 Amatlán de Cañas,12601,6433,6168
917,nay,18,4,004 Compostela,63537,31833,31704
918,nay,18,5,005 Huajicori,10244,5291,4953
919,nay,18,6,006 Ixtlán del Río,26137,12764,13373
920,nay,18,7,007 Jala,17161,8536,8625
921,nay,18,8,008 Xalisco,34595,17193,17402
922,nay,18,9,009 Nayar,24903,12654,12249
923,nay,18,10,010 Rosamorada,35007,17900,17107
924,nay,18,11,011 Ruíz,21591,11040,10551
925,nay,18,12,012 San Blas,42517,22455,20062
926,nay,18,13,013 San Pedro Lagunillas,7787,3914,3873
927,nay,18,14,014 Santa María del Oro,20714,10506,10208
928,nay,18,15,015 Santiago Ixcuintla,95385,48308,47077
929,nay,18,16,016 Tecuala,44973,22853,22120
930,nay,18,17,017 Tepic,292780,143096,149684
931,nay,18,18,018 Tuxpan,31867,15908,15959
932,nay,18,19,019 Yesca,14349,7202,7147
933,nay,18,20,020 Bahía de Banderas,47077,23870,23207
934,nl,19,0,Total Entidad,3550114,1773793,1776321
935,nl,19,1,001 Abasolo,1945,1004,941
936,nl,19,2,002 Agualeguas,4492,2273,2219
937,nl,19,3,003 Aldamas,2445,1224,1221
938,nl,19,4,004 Allende,23053,11734,11319
939,nl,19,5,005 Anáhuac,18278,9248,9030
940,nl,19,6,006 Apodaca,219153,111226,107927
941,nl,19,7,007 Aramberri,15691,8269,7422
942,nl,19,8,008 Bustamante,3308,1629,1679
943,nl,19,9,009 Cadereyta Jiménez,62440,31669,30771
944,nl,19,10,010 Carmen,6168,3151,3017
945,nl,19,11,011 Cerralvo,8287,4218,4069
946,nl,19,12,012 Ciénega de Flores,8586,4414,4172
947,nl,19,13,013 China,12064,6237,5827
948,nl,19,14,014 Doctor Arroyo,37363,19280,18083
949,nl,19,15,015 Doctor Coss,2286,1163,1123
950,nl,19,16,016 Doctor González,2912,1521,1391
951,nl,19,17,017 Galeana,42145,21734,20411
952,nl,19,18,018 García,23981,12293,11688
953,nl,19,19,019 San Pedro Garza García,120913,56981,63932
954,nl,19,20,020 General Bravo,6030,3156,2874
955,nl,19,21,021 General Escobedo,176869,89335,87534
956,nl,19,22,022 General Terán,16609,8462,8147
957,nl,19,23,023 General Treviño,1695,847,848
958,nl,19,24,024 General Zaragoza,5874,3063,2811
959,nl,19,25,025 General Zuazua,5276,2685,2591
960,nl,19,26,026 Guadalupe,618933,308157,310776
961,nl,19,27,027 Herreras,2860,1441,1419
962,nl,19,28,028 Higueras,1218,625,593
963,nl,19,29,029 Hualahuises,6535,3281,3254
964,nl,19,30,030 Iturbide,3522,1798,1724
965,nl,19,31,031 Juárez,50009,25492,24517
966,nl,19,32,032 Lampazos de Naranjo,5294,2693,2601
967,nl,19,33,033 Linares,66104,32889,33215
968,nl,19,34,034 Marín,4014,2081,1933
969,nl,19,35,035 Melchor Ocampo,1121,563,558
970,nl,19,36,036 Mier y Noriega,7721,3948,3773
971,nl,19,37,037 Mina,4783,2518,2265
972,nl,19,38,038 Montemorelos,51714,25931,25783
973,nl,19,39,039 Monterrey,1088143,539262,548881
974,nl,19,40,040 Parás,1087,583,504
975,nl,19,41,041 Pesquería,9359,4841,4518
976,nl,19,42,042 Ramones,5236,2662,2574
977,nl,19,43,043 Rayones,2791,1477,1314
978,nl,19,44,044 Sabinas Hidalgo,31521,15732,15789
979,nl,19,45,045 Salinas Victoria,15925,8852,7073
980,nl,19,46,046 San Nicolás de los Garza,487924,243451,244473
981,nl,19,47,047 Hidalgo,13552,6826,6726
982,nl,19,48,048 Santa Catarina,202156,101160,100996
983,nl,19,49,049 Santiago,34187,17380,16807
984,nl,19,50,050 Vallecillo,2188,1131,1057
985,nl,19,51,051 Villaldama,4354,2203,2151
986,oax,20,0,Total Entidad,3228895,1582410,1646485
987,oax,20,1,001 Abejones,967,487,480
988,oax,20,2,002 Acatlán de Pérez Figueroa,44006,22103,21903
989,oax,20,3,003 Asunción Cacalotepec,2631,1294,1337
990,oax,20,4,004 Asunción Cuyotepeji,845,412,433
991,oax,20,5,005 Asunción Ixtaltepec,15537,7824,7713
992,oax,20,6,006 Asunción Nochixtlán,12299,5869,6430
993,oax,20,7,007 Asunción Ocotlán,3982,1876,2106
994,oax,20,8,008 Asunción Tlacolulita,958,478,480
995,oax,20,9,009 Ayotzintepec,5087,2614,2473
996,oax,20,10,010 Barrio de la Soledad,13041,6484,6557
997,oax,20,11,011 Calihualá,1298,647,651
998,oax,20,12,012 Candelaria Loxicha,8124,4165,3959
999,oax,20,13,013 Ciénega de Zimatlán,3075,1414,1661
1000,oax,20,14,014 Ciudad Ixtepec,21498,10326,11172
1001,oax,20,15,015 Coatecas Altas,5216,2634,2582
1002,oax,20,16,016 Coicoyán de las Flores,4862,2346,2516
1003,oax,20,17,017 Compañía,4174,2039,2135
1004,oax,20,18,018 Concepción Buenavista,1004,494,510
1005,oax,20,19,019 Concepción Pápalo,3382,1741,1641
1006,oax,20,20,020 Constancia del Rosario,2976,1478,1498
1007,oax,20,21,021 Cosolapa,14547,7247,7300
1008,oax,20,22,022 Cosoltepec,1065,501,564
1009,oax,20,23,023 Cuilápam de Guerrero,11235,5499,5736
1010,oax,20,24,024 Cuyamecalco Villa de Zaragoza,4094,2070,2024
1011,oax,20,25,025 Chahuites,9266,4696,4570
1012,oax,20,26,026 Chalcatongo de Hidalgo,7881,3787,4094
1013,oax,20,27,027 Chiquihuitlán de Benito Juárez,2551,1180,1371
1014,oax,20,28,028 Heroica Ciudad de Ejutla de Crespo,18404,8844,9560
1015,oax,20,29,029 Eloxochitlán de Flores Magón,3124,1550,1574
1016,oax,20,30,030 Espinal,7921,3879,4042
1017,oax,20,31,031 Tamazulápam del Espíritu Santo,5391,2619,2772
1018,oax,20,32,032 Fresnillo de Trujano,1017,468,549
1019,oax,20,33,033 Guadalupe Etla,1770,826,944
1020,oax,20,34,034 Guadalupe de Ramírez,1309,636,673
1021,oax,20,35,035 Guelatao de Juárez,655,368,287
1022,oax,20,36,036 Guevea de Humboldt,5724,2894,2830
1023,oax,20,37,037 Mesones Hidalgo,3955,1937,2018
1024,oax,20,38,038 Villa Hidalgo,2287,1112,1175
1025,oax,20,39,039 Ciudad de Huajuapan de León,47827,22580,25247
1026,oax,20,40,040 Huautepec,5441,2675,2766
1027,oax,20,41,041 Huautla de Jiménez,27206,13016,14190
1028,oax,20,42,042 Ixtlán de Juárez,6689,3334,3355
1029,oax,20,43,043 Juchitán de Zaragoza,75946,37165,38781
1030,oax,20,44,044 Loma Bonita,41744,20387,21357
1031,oax,20,45,045 Magdalena Apasco,3845,1923,1922
1032,oax,20,46,046 Magdalena Jaltepec,3752,1830,1922
1033,oax,20,47,047 Santa Magdalena Jicotlán,121,49,72
1034,oax,20,48,048 Magdalena Mixtepec,917,451,466
1035,oax,20,49,049 Magdalena Ocotlán,959,458,501
1036,oax,20,50,050 Magdalena Peñasco,2998,1482,1516
1037,oax,20,51,051 Magdalena Teitipac,3299,1617,1682
1038,oax,20,52,052 Magdalena Tequisistlán,6625,3362,3263
1039,oax,20,53,053 Magdalena Tlacotepec,1225,589,636
1040,oax,20,54,054 Magdalena Zahuatlán,469,237,232
1041,oax,20,55,055 Mariscala de Juárez,3292,1616,1676
1042,oax,20,56,056 Mártires de Tacubaya,1417,703,714
1043,oax,20,57,057 Matías Romero,40018,19816,20202
1044,oax,20,58,058 Mazatlán Villa de Flores,13102,6664,6438
1045,oax,20,59,059 Miahuatlán de Porfirio Díaz,28918,14069,14849
1046,oax,20,60,060 Mixistlán de la Reforma,2552,1231,1321
1047,oax,20,61,061 Monjas,2150,1038,1112
1048,oax,20,62,062 Natividad,624,288,336
1049,oax,20,63,063 Nazareno Etla,2961,1442,1519
1050,oax,20,64,064 Nejapa de Madero,7930,3990,3940
1051,oax,20,65,065 Ixpantepec Nieves,2030,921,1109
1052,oax,20,66,066 Santiago Niltepec,5693,2922,2771
1053,oax,20,67,067 Oaxaca de Juárez,244827,115207,129620
1054,oax,20,68,068 Ocotlán de Morelos,17180,8323,8857
1055,oax,20,69,069 Pe,1747,829,918
1056,oax,20,70,070 Pinotepa de Don Luis,5841,2867,2974
1057,oax,20,71,071 Pluma Hidalgo,3442,1719,1723
1058,oax,20,72,072 San José del Progreso,5570,2745,2825
1059,oax,20,73,073 Putla Villa de Guerrero,26154,12618,13536
1060,oax,20,74,074 Santa Catarina Quioquitani,355,185,170
1061,oax,20,75,075 Reforma de Pineda,2580,1308,1272
1062,oax,20,76,076 Reforma,3338,1612,1726
1063,oax,20,77,077 Reyes Etla,2566,1252,1314
1064,oax,20,78,078 Rojas de Cuauhtémoc,1047,531,516
1065,oax,20,79,079 Salina Cruz,76198,37408,38790
1066,oax,20,80,080 San Agustín Amatengo,1883,899,984
1067,oax,20,81,081 San Agustín Atenango,2422,1098,1324
1068,oax,20,82,082 San Agustín Chayuco,4568,2295,2273
1069,oax,20,83,083 San Agustín de las Juntas,3898,1922,1976
1070,oax,20,84,084 San Agustín Etla,2952,1453,1499
1071,oax,20,85,085 San Agustín Loxicha,18839,9494,9345
1072,oax,20,86,086 San Agustín Tlacotepec,824,380,444
1073,oax,20,87,087 San Agustín Yatareni,2910,1364,1546
1074,oax,20,88,088 San Andrés Cabecera Nueva,3266,1599,1667
1075,oax,20,89,089 San Andrés Dinicuiti,2156,1059,1097
1076,oax,20,90,090 San Andrés Huaxpaltepec,5354,2663,2691
1077,oax,20,91,091 San Andrés Huayápam,3199,1504,1695
1078,oax,20,92,092 San Andrés Ixtlahuaca,1474,702,772
1079,oax,20,93,093 San Andrés Lagunas,610,295,315
1080,oax,20,94,094 San Andrés Nuxiño,2168,1061,1107
1081,oax,20,95,095 San Andrés Paxtlán,2884,1471,1413
1082,oax,20,96,096 San Andrés Sinaxtla,700,341,359
1083,oax,20,97,097 San Andrés Solaga,1869,929,940
1084,oax,20,98,098 San Andrés Teotilálpam,4070,2011,2059
1085,oax,20,99,099 San Andrés Tepetlapa,352,173,179
1086,oax,20,100,100 San Andrés Yaá,609,289,320
1087,oax,20,101,101 San Andrés Zabache,1051,490,561
1088,oax,20,102,102 San Andrés Zautla,2910,1415,1495
1089,oax,20,103,103 San Antonino Castillo Velasco,4739,2271,2468
1090,oax,20,104,104 San Antonino el Alto,1866,942,924
1091,oax,20,105,105 San Antonino Monte Verde,5585,2746,2839
1092,oax,20,106,106 San Antonio Acutla,331,146,185
1093,oax,20,107,107 San Antonio de la Cal,11214,5422,5792
1094,oax,20,108,108 San Antonio Huitepec,4346,2078,2268
1095,oax,20,109,109 San Antonio Nanahuatípam,1266,637,629
1096,oax,20,110,110 San Antonio Sinicahua,1228,569,659
1097,oax,20,111,111 San Antonio Tepetlapa,3527,1746,1781
1098,oax,20,112,112 San Baltazar Chichicápam,2953,1435,1518
1099,oax,20,113,113 San Baltazar Loxicha,2662,1301,1361
1100,oax,20,114,114 San Baltazar Yatzachi el Bajo,780,369,411
1101,oax,20,115,115 San Bartolo Coyotepec,4083,1960,2123
1102,oax,20,116,116 San Bartolomé Ayautla,2871,1399,1472
1103,oax,20,117,117 San Bartolomé Loxicha,2275,1132,1143
1104,oax,20,118,118 San Bartolomé Quialana,2534,1160,1374
1105,oax,20,119,119 San Bartolomé Yucuañe,546,241,305
1106,oax,20,120,120 San Bartolomé Zoogocho,730,371,359
1107,oax,20,121,121 San Bartolo Soyaltepec,895,418,477
1108,oax,20,122,122 San Bartolo Yautepec,772,399,373
1109,oax,20,123,123 San Bernardo Mixtepec,3028,1505,1523
1110,oax,20,124,124 San Blas Atempa,14453,7052,7401
1111,oax,20,125,125 San Carlos Yautepec,10988,5506,5482
1112,oax,20,126,126 San Cristóbal Amatlán,3801,1873,1928
1113,oax,20,127,127 San Cristóbal Amoltepec,1101,540,561
1114,oax,20,128,128 San Cristóbal Lachirioag,1264,624,640
1115,oax,20,129,129 San Cristóbal Suchixtlahuaca,328,157,171
1116,oax,20,130,130 San Dionisio del Mar,4438,2262,2176
1117,oax,20,131,131 San Dionisio Ocotepec,9004,4482,4522
1118,oax,20,132,132 San Dionisio Ocotlán,1136,554,582
1119,oax,20,133,133 San Esteban Atatlahuca,3443,1735,1708
1120,oax,20,134,134 San Felipe Jalapa de Díaz,19040,9471,9569
1121,oax,20,135,135 San Felipe Tejalápam,5815,2864,2951
1122,oax,20,136,136 San Felipe Usila,10597,5210,5387
1123,oax,20,137,137 San Francisco Cahuacuá,2998,1487,1511
1124,oax,20,138,138 San Francisco Cajonos,733,351,382
1125,oax,20,139,139 San Francisco Chapulapa,1967,983,984
1126,oax,20,140,140 San Francisco Chindúa,735,374,361
1127,oax,20,141,141 San Francisco del Mar,4850,2555,2295
1128,oax,20,142,142 San Francisco Huehuetlán,1028,495,533
1129,oax,20,143,143 San Francisco Ixhuatán,9313,4725,4588
1130,oax,20,144,144 San Francisco Jaltepetongo,1256,600,656
1131,oax,20,145,145 San Francisco Lachigoló,1616,814,802
1132,oax,20,146,146 San Francisco Logueche,1722,824,898
1133,oax,20,147,147 San Francisco Nuxaño,424,215,209
1134,oax,20,148,148 San Francisco Ozolotepec,1879,949,930
1135,oax,20,149,149 San Francisco Sola,1221,590,631
1136,oax,20,150,150 San Francisco Telixtlahuaca,8681,4147,4534
1137,oax,20,151,151 San Francisco Teopan,427,222,205
1138,oax,20,152,152 San Francisco Tlapancingo,1688,827,861
1139,oax,20,153,153 San Gabriel Mixtepec,3519,1743,1776
1140,oax,20,154,154 San Ildefonso Amatlán,1980,976,1004
1141,oax,20,155,155 San Ildefonso Sola,840,420,420
1142,oax,20,156,156 San Ildefonso Villa Alta,3164,1532,1632
1143,oax,20,157,157 San Jacinto Amilpas,3834,1860,1974
1144,oax,20,158,158 San Jacinto Tlacotepec,2108,1044,1064
1145,oax,20,159,159 San Jerónimo Coatlán,3580,1766,1814
1146,oax,20,160,160 San Jerónimo Silacayoapilla,1901,957,944
1147,oax,20,161,161 San Jerónimo Sosola,2620,1253,1367
1148,oax,20,162,162 San Jerónimo Taviche,1491,725,766
1149,oax,20,163,163 San Jerónimo Tecóatl,1542,724,818
1150,oax,20,164,164 San Jorge Nuchita,3321,1551,1770
1151,oax,20,165,165 San José Ayuquila,1288,619,669
1152,oax,20,166,166 San José Chiltepec,9612,4836,4776
1153,oax,20,167,167 San José del Peñasco,1362,687,675
1154,oax,20,168,168 San José Estancia Grande,877,435,442
1155,oax,20,169,169 San José Independencia,4100,2018,2082
1156,oax,20,170,170 San José Lachiguiri,3399,1627,1772
1157,oax,20,171,171 San José Tenango,16449,8159,8290
1158,oax,20,172,172 San Juan Achiutla,455,219,236
1159,oax,20,173,173 San Juan Atepec,1678,820,858
1160,oax,20,174,174 Ánimas Trujano,2514,1210,1304
1161,oax,20,175,175 San Juan Bautista Atatlahuca,1680,854,826
1162,oax,20,176,176 San Juan Bautista Coixtlahuaca,3398,1679,1719
1163,oax,20,177,177 San Juan Bautista Cuicatlán,9226,4582,4644
1164,oax,20,178,178 San Juan Bautista Guelache,3131,1565,1566
1165,oax,20,179,179 San Juan Bautista Jayacatlán,1447,734,713
1166,oax,20,180,180 San Juan Bautista Lo de Soto,2653,1361,1292
1167,oax,20,181,181 San Juan Bautista Suchitepec,515,268,247
1168,oax,20,182,182 San Juan Bautista Tlacoatzintepec,2182,1080,1102
1169,oax,20,183,183 San Juan Bautista Tlachichilco,1367,649,718
1170,oax,20,184,184 San Juan Bautista Tuxtepec,127707,62884,64823
1171,oax,20,185,185 San Juan Cacahuatepec,7812,3778,4034
1172,oax,20,186,186 San Juan Cieneguilla,593,293,300
1173,oax,20,187,187 San Juan Coatzóspam,2176,1089,1087
1174,oax,20,188,188 San Juan Colorado,7801,3840,3961
1175,oax,20,189,189 San Juan Comaltepec,1937,967,970
1176,oax,20,190,190 San Juan Cotzocón,21362,10615,10747
1177,oax,20,191,191 San Juan Chicomezúchil,365,167,198
1178,oax,20,192,192 San Juan Chilateca,1303,621,682
1179,oax,20,193,193 San Juan del Estado,2134,1034,1100
1180,oax,20,194,194 San Juan del Río,1277,589,688
1181,oax,20,195,195 San Juan Diuxi,1784,882,902
1182,oax,20,196,196 San Juan Evangelista Analco,524,252,272
1183,oax,20,197,197 San Juan Guelavía,2811,1354,1457
1184,oax,20,198,198 San Juan Guichicovi,25096,12323,12773
1185,oax,20,199,199 San Juan Ihualtepec,751,369,382
1186,oax,20,200,200 San Juan Juquila Mixes,3517,1712,1805
1187,oax,20,201,201 San Juan Juquila Vijanos,1672,804,868
1188,oax,20,202,202 San Juan Lachao,3340,1665,1675
1189,oax,20,203,203 San Juan Lachigalla,2740,1371,1369
1190,oax,20,204,204 San Juan Lajarcia,737,354,383
1191,oax,20,205,205 San Juan Lalana,15321,7593,7728
1192,oax,20,206,206 San Juan de los Cués,2583,1339,1244
1193,oax,20,207,207 San Juan Mazatlán,16547,8504,8043
1194,oax,20,208,208 San Juan Mixtepec -Dto. 08 -,9246,4429,4817
1195,oax,20,209,209 San Juan Mixtepec -Dto. 26 -,714,312,402
1196,oax,20,210,210 San Juan Ñumí,6221,3067,3154
1197,oax,20,211,211 San Juan Ozolotepec,3009,1495,1514
1198,oax,20,212,212 San Juan Petlapa,2091,1021,1070
1199,oax,20,213,213 San Juan Quiahije,3570,1716,1854
1200,oax,20,214,214 San Juan Quiotepec,2367,1159,1208
1201,oax,20,215,215 San Juan Sayultepec,660,315,345
1202,oax,20,216,216 San Juan Tabaá,1130,545,585
1203,oax,20,217,217 San Juan Tamazola,3379,1665,1714
1204,oax,20,218,218 San Juan Teita,455,214,241
1205,oax,20,219,219 San Juan Teitipac,2945,1436,1509
1206,oax,20,220,220 San Juan Tepeuxila,3045,1580,1465
1207,oax,20,221,221 San Juan Teposcolula,1393,674,719
1208,oax,20,222,222 San Juan Yaeé,1491,703,788
1209,oax,20,223,223 San Juan Yatzona,504,244,260
1210,oax,20,224,224 San Juan Yucuita,743,355,388
1211,oax,20,225,225 San Lorenzo,5047,2478,2569
1212,oax,20,226,226 San Lorenzo Albarradas,2524,1284,1240
1213,oax,20,227,227 San Lorenzo Cacaotepec,8341,4077,4264
1214,oax,20,228,228 San Lorenzo Cuaunecuiltitla,598,296,302
1215,oax,20,229,229 San Lorenzo Texmelúcan,4703,2257,2446
1216,oax,20,230,230 San Lorenzo Victoria,1084,515,569
1217,oax,20,231,231 San Lucas Camotlán,2568,1346,1222
1218,oax,20,232,232 San Lucas Ojitlán,18449,9040,9409
1219,oax,20,233,233 San Lucas Quiaviní,2088,971,1117
1220,oax,20,234,234 San Lucas Zoquiápam,6139,3027,3112
1221,oax,20,235,235 San Luis Amatlán,3771,1757,2014
1222,oax,20,236,236 San Marcial Ozolotepec,1736,875,861
1223,oax,20,237,237 San Marcos Arteaga,2223,1065,1158
1224,oax,20,238,238 San Martín de los Cansecos,828,414,414
1225,oax,20,239,239 San Martín Huamelúlpam,1022,474,548
1226,oax,20,240,240 San Martín Itunyoso,2299,1097,1202
1227,oax,20,241,241 San Martín Lachilá,1288,612,676
1228,oax,20,242,242 San Martín Peras,7742,3884,3858
1229,oax,20,243,243 San Martín Tilcajete,1649,846,803
1230,oax,20,244,244 San Martín Toxpalan,2910,1450,1460
1231,oax,20,245,245 San Martín Zacatepec,1399,649,750
1232,oax,20,246,246 San Mateo Cajonos,620,282,338
1233,oax,20,247,247 Capulálpam de Méndez,1377,621,756
1234,oax,20,248,248 San Mateo del Mar,9522,4931,4591
1235,oax,20,249,249 San Mateo Yoloxochitlán,2934,1483,1451
1236,oax,20,250,250 San Mateo Etlatongo,1121,540,581
1237,oax,20,251,251 San Mateo Nejápam,1147,531,616
1238,oax,20,252,252 San Mateo Peñasco,1563,749,814
1239,oax,20,253,253 San Mateo Piñas,4343,2229,2114
1240,oax,20,254,254 San Mateo Río Hondo,3642,1767,1875
1241,oax,20,255,255 San Mateo Sindihui,1867,923,944
1242,oax,20,256,256 San Mateo Tlapiltepec,278,149,129
1243,oax,20,257,257 San Melchor Betaza,1027,477,550
1244,oax,20,258,258 San Miguel Achiutla,824,411,413
1245,oax,20,259,259 San Miguel Ahuehuetitlán,2130,1045,1085
1246,oax,20,260,260 San Miguel Aloápam,2461,1212,1249
1247,oax,20,261,261 San Miguel Amatitlán,6139,3009,3130
1248,oax,20,262,262 San Miguel Amatlán,1244,639,605
1249,oax,20,263,263 San Miguel Coatlán,2880,1461,1419
1250,oax,20,264,264 San Miguel Chicahua,2200,1035,1165
1251,oax,20,265,265 San Miguel Chimalapa,6013,3025,2988
1252,oax,20,266,266 San Miguel del Puerto,8098,4143,3955
1253,oax,20,267,267 San Miguel del Río,302,135,167
1254,oax,20,268,268 San Miguel Ejutla,882,423,459
1255,oax,20,269,269 San Miguel el Grande,4128,1887,2241
1256,oax,20,270,270 San Miguel Huautla,1671,823,848
1257,oax,20,271,271 San Miguel Mixtepec,2168,1044,1124
1258,oax,20,272,272 San Miguel Panixtlahuaca,5226,2583,2643
1259,oax,20,273,273 San Miguel Peras,3148,1579,1569
1260,oax,20,274,274 San Miguel Piedras,1358,676,682
1261,oax,20,275,275 San Miguel Quetzaltepec,5303,2669,2634
1262,oax,20,276,276 San Miguel Santa Flor,1160,596,564
1263,oax,20,277,277 Villa Sola de Vega,12414,6148,6266
1264,oax,20,278,278 San Miguel Soyaltepec,33887,17031,16856
1265,oax,20,279,279 San Miguel Suchixtepec,2677,1344,1333
1266,oax,20,280,280 Villa Talea de Castro,2685,1307,1378
1267,oax,20,281,281 San Miguel Tecomatlán,262,122,140
1268,oax,20,282,282 San Miguel Tenango,989,505,484
1269,oax,20,283,283 San Miguel Tequixtepec,1093,567,526
1270,oax,20,284,284 San Miguel Tilquiápam,3398,1673,1725
1271,oax,20,285,285 San Miguel Tlacamama,2860,1422,1438
1272,oax,20,286,286 San Miguel Tlacotepec,3335,1541,1794
1273,oax,20,287,287 San Miguel Tulancingo,490,201,289
1274,oax,20,288,288 San Miguel Yotao,498,252,246
1275,oax,20,289,289 San Nicolás,1248,593,655
1276,oax,20,290,290 San Nicolás Hidalgo,860,406,454
1277,oax,20,291,291 San Pablo Coatlán,3862,1906,1956
1278,oax,20,292,292 San Pablo Cuatro Venados,1334,648,686
1279,oax,20,293,293 San Pablo Etla,4670,2348,2322
1280,oax,20,294,294 San Pablo Huitzo,4969,2390,2579
1281,oax,20,295,295 San Pablo Huixtepec,8307,3979,4328
1282,oax,20,296,296 San Pablo Macuiltianguis,1265,642,623
1283,oax,20,297,297 San Pablo Tijaltepec,2252,1116,1136
1284,oax,20,298,298 San Pablo Villa de Mitla,10642,5111,5531
1285,oax,20,299,299 San Pablo Yaganiza,1080,514,566
1286,oax,20,300,300 San Pedro Amuzgos,4949,2421,2528
1287,oax,20,301,301 San Pedro Apóstol,1706,806,900
1288,oax,20,302,302 San Pedro Atoyac,3500,1693,1807
1289,oax,20,303,303 San Pedro Cajonos,1307,575,732
1290,oax,20,304,304 San Pedro Coxcaltepec Cántaros,1077,530,547
1291,oax,20,305,305 San Pedro Comitancillo,3867,1853,2014
1292,oax,20,306,306 San Pedro el Alto,3570,1805,1765
1293,oax,20,307,307 San Pedro Huamelula,8865,4523,4342
1294,oax,20,308,308 San Pedro Huilotepec,2396,1220,1176
1295,oax,20,309,309 San Pedro Ixcatlán,9858,4927,4931
1296,oax,20,310,310 San Pedro Ixtlahuaca,3174,1611,1563
1297,oax,20,311,311 San Pedro Jaltepetongo,663,318,345
1298,oax,20,312,312 San Pedro Jicayán,9388,4690,4698
1299,oax,20,313,313 San Pedro Jocotipac,1122,546,576
1300,oax,20,314,314 San Pedro Juchatengo,1590,771,819
1301,oax,20,315,315 San Pedro Mártir,1943,915,1028
1302,oax,20,316,316 San Pedro Mártir Quiechapa,776,381,395
1303,oax,20,317,317 San Pedro Mártir Yucuxaco,1544,777,767
1304,oax,20,318,318 San Pedro Mixtepec -Dto. 22 -,27111,13318,13793
1305,oax,20,319,319 San Pedro Mixtepec -Dto. 26 -,1227,584,643
1306,oax,20,320,320 San Pedro Molinos,768,357,411
1307,oax,20,321,321 San Pedro Nopala,1031,481,550
1308,oax,20,322,322 San Pedro Ocopetatillo,815,388,427
1309,oax,20,323,323 San Pedro Ocotepec,1807,954,853
1310,oax,20,324,324 San Pedro Pochutla,30911,15675,15236
1311,oax,20,325,325 San Pedro Quiatoni,8036,3942,4094
1312,oax,20,326,326 San Pedro Sochiápam,4459,2185,2274
1313,oax,20,327,327 San Pedro Tapanatepec,14203,7211,6992
1314,oax,20,328,328 San Pedro Taviche,919,472,447
1315,oax,20,329,329 San Pedro Teozacoalco,1356,662,694
1316,oax,20,330,330 San Pedro Teutila,3591,1802,1789
1317,oax,20,331,331 San Pedro Tidaá,926,434,492
1318,oax,20,332,332 San Pedro Topiltepec,452,219,233
1319,oax,20,333,333 San Pedro Totolapa,3017,1449,1568
1320,oax,20,334,334 Villa de Tututepec de Melchor Ocampo,40501,20395,20106
1321,oax,20,335,335 San Pedro Yaneri,930,468,462
1322,oax,20,336,336 San Pedro Yólox,2572,1283,1289
1323,oax,20,337,337 San Pedro y San Pablo Ayutla,4767,2328,2439
1324,oax,20,338,338 Villa de Etla,6319,3073,3246
1325,oax,20,339,339 San Pedro y San Pablo Teposcolula,3454,1672,1782
1326,oax,20,340,340 San Pedro y San Pablo Tequixtepec,2529,1128,1401
1327,oax,20,341,341 San Pedro Yucunama,262,119,143
1328,oax,20,342,342 San Raymundo Jalpan,1555,743,812
1329,oax,20,343,343 San Sebastián Abasolo,2032,996,1036
1330,oax,20,344,344 San Sebastián Coatlán,2363,1148,1215
1331,oax,20,345,345 San Sebastián Ixcapa,3951,1973,1978
1332,oax,20,346,346 San Sebastián Nicananduta,1582,739,843
1333,oax,20,347,347 San Sebastián Río Hondo,2758,1376,1382
1334,oax,20,348,348 San Sebastián Tecomaxtlahuaca,8861,4165,4696
1335,oax,20,349,349 San Sebastián Teitipac,2204,1051,1153
1336,oax,20,350,350 San Sebastián Tutla,12293,5750,6543
1337,oax,20,351,351 San Simón Almolongas,3021,1510,1511
1338,oax,20,352,352 San Simón Zahuatlán,1810,942,868
1339,oax,20,353,353 Santa Ana,1596,830,766
1340,oax,20,354,354 Santa Ana Ateixtlahuaca,559,271,288
1341,oax,20,355,355 Santa Ana Cuauhtémoc,948,474,474
1342,oax,20,356,356 Santa Ana del Valle,2147,1051,1096
1343,oax,20,357,357 Santa Ana Tavela,1137,564,573
1344,oax,20,358,358 Santa Ana Tlapacoyan,2388,1083,1305
1345,oax,20,359,359 Santa Ana Yareni,1157,556,601
1346,oax,20,360,360 Santa Ana Zegache,3512,1676,1836
1347,oax,20,361,361 Santa Catalina Quierí,875,422,453
1348,oax,20,362,362 Santa Catarina Cuixtla,1719,810,909
1349,oax,20,363,363 Santa Catarina Ixtepeji,2358,1191,1167
1350,oax,20,364,364 Santa Catarina Juquila,12560,6090,6470
1351,oax,20,365,365 Santa Catarina Lachatao,1558,788,770
1352,oax,20,366,366 Santa Catarina Loxicha,4375,2188,2187
1353,oax,20,367,367 Santa Catarina Mechoacán,3997,1987,2010
1354,oax,20,368,368 Santa Catarina Minas,1594,795,799
1355,oax,20,369,369 Santa Catarina Quiané,1791,875,916
1356,oax,20,370,370 Santa Catarina Tayata,773,366,407
1357,oax,20,371,371 Santa Catarina Ticuá,859,393,466
1358,oax,20,372,372 Santa Catarina Yosonotú,1832,855,977
1359,oax,20,373,373 Santa Catarina Zapoquila,703,364,339
1360,oax,20,374,374 Santa Cruz Acatepec,986,489,497
1361,oax,20,375,375 Santa Cruz Amilpas,5737,2722,3015
1362,oax,20,376,376 Santa Cruz de Bravo,447,206,241
1363,oax,20,377,377 Santa Cruz Itundujia,9434,4634,4800
1364,oax,20,378,378 Santa Cruz Mixtepec,3284,1637,1647
1365,oax,20,379,379 Santa Cruz Nundaco,2525,1191,1334
1366,oax,20,380,380 Santa Cruz Papalutla,1699,847,852
1367,oax,20,381,381 Santa Cruz Tacache de Mina,2539,1212,1327
1368,oax,20,382,382 Santa Cruz Tacahua,1336,633,703
1369,oax,20,383,383 Santa Cruz Tayata,495,239,256
1370,oax,20,384,384 Santa Cruz Xitla,3542,1823,1719
1371,oax,20,385,385 Santa Cruz Xoxocotlán,40815,19729,21086
1372,oax,20,386,386 Santa Cruz Zenzontepec,13978,7002,6976
1373,oax,20,387,387 Santa Gertrudis,3670,1756,1914
1374,oax,20,388,388 Santa Inés del Monte,2209,1110,1099
1375,oax,20,389,389 Santa Inés Yatzeche,1332,619,713
1376,oax,20,390,390 Santa Lucía del Camino,35631,17687,17944
1377,oax,20,391,391 Santa Lucía Miahuatlán,2406,1225,1181
1378,oax,20,392,392 Santa Lucía Monteverde,6979,3408,3571
1379,oax,20,393,393 Santa Lucía Ocotlán,3183,1545,1638
1380,oax,20,394,394 Santa María Alotepec,2610,1304,1306
1381,oax,20,395,395 Santa María Apazco,2422,1186,1236
1382,oax,20,396,396 Santa María la Asunción,3124,1447,1677
1383,oax,20,397,397 Heroica Ciudad de Tlaxiaco,24784,11838,12946
1384,oax,20,398,398 Ayoquezco de Aldama,5750,2774,2976
1385,oax,20,399,399 Santa María Atzompa,11293,5469,5824
1386,oax,20,400,400 Santa María Camotlán,1507,734,773
1387,oax,20,401,401 Santa María Colotepec,15646,7943,7703
1388,oax,20,402,402 Santa María Cortijo,1124,576,548
1389,oax,20,403,403 Santa María Coyotepec,1550,765,785
1390,oax,20,404,404 Santa María Chachoápam,850,403,447
1391,oax,20,405,405 Villa de Chilapa de Díaz,1865,819,1046
1392,oax,20,406,406 Santa María Chilchotla,18745,9389,9356
1393,oax,20,407,407 Santa María Chimalapa,7080,3622,3458
1394,oax,20,408,408 Santa María del Rosario,430,210,220
1395,oax,20,409,409 Santa María del Tule,7182,3342,3840
1396,oax,20,410,410 Santa María Ecatepec,3608,1823,1785
1397,oax,20,411,411 Santa María Guelacé,729,343,386
1398,oax,20,412,412 Santa María Guienagati,2794,1412,1382
1399,oax,20,413,413 Santa María Huatulco,25242,12591,12651
1400,oax,20,414,414 Santa María Huazolotitlán,9895,5002,4893
1401,oax,20,415,415 Santa María Ipalapa,4447,2164,2283
1402,oax,20,416,416 Santa María Ixcatlán,686,328,358
1403,oax,20,417,417 Santa María Jacatepec,9242,4647,4595
1404,oax,20,418,418 Santa María Jalapa del Marqués,11242,5495,5747
1405,oax,20,419,419 Santa María Jaltianguis,657,305,352
1406,oax,20,420,420 Santa María Lachixío,915,432,483
1407,oax,20,421,421 Santa María Mixtequilla,3787,1890,1897
1408,oax,20,422,422 Santa María Nativitas,800,364,436
1409,oax,20,423,423 Santa María Nduayaco,660,314,346
1410,oax,20,424,424 Santa María Ozolotepec,4085,2036,2049
1411,oax,20,425,425 Santa María Pápalo,1958,977,981
1412,oax,20,426,426 Santa María Peñoles,6758,3290,3468
1413,oax,20,427,427 Santa María Petapa,13037,6463,6574
1414,oax,20,428,428 Santa María Quiegolani,1500,779,721
1415,oax,20,429,429 Santa María Sola,1741,891,850
1416,oax,20,430,430 Santa María Tataltepec,293,144,149
1417,oax,20,431,431 Santa María Tecomavaca,1888,931,957
1418,oax,20,432,432 Santa María Temaxcalapa,933,459,474
1419,oax,20,433,433 Santa María Temaxcaltepec,1673,814,859
1420,oax,20,434,434 Santa María Teopoxco,3965,1952,2013
1421,oax,20,435,435 Santa María Tepantlali,2453,1222,1231
1422,oax,20,436,436 Santa María Texcatitlán,1122,555,567
1423,oax,20,437,437 Santa María Tlahuitoltepec,6982,3412,3570
1424,oax,20,438,438 Santa María Tlalixtac,1479,764,715
1425,oax,20,439,439 Santa María Tonameca,16546,8420,8126
1426,oax,20,440,440 Santa María Totolapilla,1112,551,561
1427,oax,20,441,441 Santa María Xadani,5848,2958,2890
1428,oax,20,442,442 Santa María Yalina,414,184,230
1429,oax,20,443,443 Santa María Yavesía,479,232,247
1430,oax,20,444,444 Santa María Yolotepec,575,291,284
1431,oax,20,445,445 Santa María Yosoyúa,1371,668,703
1432,oax,20,446,446 Santa María Yucuhiti,6335,3135,3200
1433,oax,20,447,447 Santa María Zacatepec,14822,7225,7597
1434,oax,20,448,448 Santa María Zaniza,1296,633,663
1435,oax,20,449,449 Santa María Zoquitlán,4086,2020,2066
1436,oax,20,450,450 Santiago Amoltepec,8576,4246,4330
1437,oax,20,451,451 Santiago Apoala,1321,659,662
1438,oax,20,452,452 Santiago Apóstol,4761,2249,2512
1439,oax,20,453,453 Santiago Astata,2606,1325,1281
1440,oax,20,454,454 Santiago Atitlán,2475,1280,1195
1441,oax,20,455,455 Santiago Ayuquililla,2242,1048,1194
1442,oax,20,456,456 Santiago Cacaloxtepec,1275,643,632
1443,oax,20,457,457 Santiago Camotlán,3019,1514,1505
1444,oax,20,458,458 Santiago Comaltepec,1752,834,918
1445,oax,20,459,459 Santiago Chazumba,4600,2201,2399
1446,oax,20,460,460 Santiago Choápam,4241,2066,2175
1447,oax,20,461,461 Santiago del Río,921,450,471
1448,oax,20,462,462 Santiago Huajolotitlán,4555,2142,2413
1449,oax,20,463,463 Santiago Huauclilla,976,474,502
1450,oax,20,464,464 Santiago Ihuitlán Plumas,625,285,340
1451,oax,20,465,465 Santiago Ixcuintepec,1236,618,618
1452,oax,20,466,466 Santiago Ixtayutla,8732,4357,4375
1453,oax,20,467,467 Santiago Jamiltepec,17794,8805,8989
1454,oax,20,468,468 Santiago Jocotepec,11331,5620,5711
1455,oax,20,469,469 Santiago Juxtlahuaca,29416,14538,14878
1456,oax,20,470,470 Santiago Lachiguiri,5873,2977,2896
1457,oax,20,471,471 Santiago Lalopa,507,239,268
1458,oax,20,472,472 Santiago Laollaga,2883,1437,1446
1459,oax,20,473,473 Santiago Laxopa,1519,718,801
1460,oax,20,474,474 Santiago Llano Grande,3449,1698,1751
1461,oax,20,475,475 Santiago Matatlán,7993,3902,4091
1462,oax,20,476,476 Santiago Miltepec,424,193,231
1463,oax,20,477,477 Santiago Minas,1721,883,838
1464,oax,20,478,478 Santiago Nacaltepec,2700,1363,1337
1465,oax,20,479,479 Santiago Nejapilla,296,150,146
1466,oax,20,480,480 Santiago Nundiche,1038,521,517
1467,oax,20,481,481 Santiago Nuyoó,2975,1455,1520
1468,oax,20,482,482 Santiago Pinotepa Nacional,42116,20802,21314
1469,oax,20,483,483 Santiago Suchilquitongo,6828,3400,3428
1470,oax,20,484,484 Santiago Tamazola,3185,1487,1698
1471,oax,20,485,485 Santiago Tapextla,3473,1829,1644
1472,oax,20,486,486 Villa Tejúpam de la Unión,2201,1069,1132
1473,oax,20,487,487 Santiago Tenango,1672,857,815
1474,oax,20,488,488 Santiago Tepetlapa,132,66,66
1475,oax,20,489,489 Santiago Tetepec,4825,2441,2384
1476,oax,20,490,490 Santiago Texcalcingo,2480,1220,1260
1477,oax,20,491,491 Santiago Textitlán,2717,1359,1358
1478,oax,20,492,492 Santiago Tilantongo,4117,1976,2141
1479,oax,20,493,493 Santiago Tillo,512,247,265
1480,oax,20,494,494 Santiago Tlazoyaltepec,4512,2123,2389
1481,oax,20,495,495 Santiago Xanica,3285,1640,1645
1482,oax,20,496,496 Santiago Xiacuí,1934,926,1008
1483,oax,20,497,497 Santiago Yaitepec,3242,1569,1673
1484,oax,20,498,498 Santiago Yaveo,6696,3431,3265
1485,oax,20,499,499 Santiago Yolomécatl,1729,800,929
1486,oax,20,500,500 Santiago Yosondúa,7660,3747,3913
1487,oax,20,501,501 Santiago Yucuyachi,1311,578,733
1488,oax,20,502,502 Santiago Zacatepec,5136,2627,2509
1489,oax,20,503,503 Santiago Zoochila,471,231,240
1490,oax,20,504,504 Nuevo Zoquiápam,1690,854,836
1491,oax,20,505,505 Santo Domingo Ingenio,8091,4073,4018
1492,oax,20,506,506 Santo Domingo Albarradas,827,405,422
1493,oax,20,507,507 Santo Domingo Armenta,3246,1693,1553
1494,oax,20,508,508 Santo Domingo Chihuitán,1438,731,707
1495,oax,20,509,509 Santo Domingo de Morelos,6496,3377,3119
1496,oax,20,510,510 Santo Domingo Ixcatlán,857,393,464
1497,oax,20,511,511 Santo Domingo Nuxaá,3141,1592,1549
1498,oax,20,512,512 Santo Domingo Ozolotepec,1114,552,562
1499,oax,20,513,513 Santo Domingo Petapa,7786,3951,3835
1500,oax,20,514,514 Santo Domingo Roayaga,831,408,423
1501,oax,20,515,515 Santo Domingo Tehuantepec,52142,25782,26360
1502,oax,20,516,516 Santo Domingo Teojomulco,4044,1971,2073
1503,oax,20,517,517 Santo Domingo Tepuxtepec,2710,1324,1386
1504,oax,20,518,518 Santo Domingo Tlatayápam,161,77,84
1505,oax,20,519,519 Santo Domingo Tomaltepec,2679,1353,1326
1506,oax,20,520,520 Santo Domingo Tonalá,6631,3134,3497
1507,oax,20,521,521 Santo Domingo Tonaltepec,347,146,201
1508,oax,20,522,522 Santo Domingo Xagacía,1027,507,520
1509,oax,20,523,523 Santo Domingo Yanhuitlán,1630,762,868
1510,oax,20,524,524 Santo Domingo Yodohino,573,277,296
1511,oax,20,525,525 Santo Domingo Zanatepec,10153,5171,4982
1512,oax,20,526,526 Santos Reyes Nopala,11403,5763,5640
1513,oax,20,527,527 Santos Reyes Pápalo,2300,1148,1152
1514,oax,20,528,528 Santos Reyes Tepejillo,1595,754,841
1515,oax,20,529,529 Santos Reyes Yucuná,1345,669,676
1516,oax,20,530,530 Santo Tomás Jalieza,2822,1388,1434
1517,oax,20,531,531 Santo Tomás Mazaltepec,2021,1012,1009
1518,oax,20,532,532 Santo Tomás Ocotepec,3939,1948,1991
1519,oax,20,533,533 Santo Tomás Tamazulapan,1633,796,837
1520,oax,20,534,534 San Vicente Coatlán,3587,1766,1821
1521,oax,20,535,535 San Vicente Lachixío,2870,1365,1505
1522,oax,20,536,536 San Vicente Nuñú,568,272,296
1523,oax,20,537,537 Silacayoápam,8293,3831,4462
1524,oax,20,538,538 Sitio de Xitlapehua,634,315,319
1525,oax,20,539,539 Soledad Etla,3352,1661,1691
1526,oax,20,540,540 Villa de Tamazulápam del Progreso,6202,2735,3467
1527,oax,20,541,541 Tanetze de Zaragoza,1821,898,923
1528,oax,20,542,542 Taniche,990,463,527
1529,oax,20,543,543 Tataltepec de Valdés,4954,2441,2513
1530,oax,20,544,544 Teococuilco de Marcos Pérez,1729,872,857
1531,oax,20,545,545 Teotitlán de Flores Magón,7084,3418,3666
1532,oax,20,546,546 Teotitlán del Valle,5330,2626,2704
1533,oax,20,547,547 Teotongo,1154,538,616
1534,oax,20,548,548 Tepelmeme Villa de Morelos,1645,791,854
1535,oax,20,549,549 Tezoatlán de Segura y Luna,12008,5529,6479
1536,oax,20,550,550 San Jerónimo Tlacochahuaya,4694,2223,2471
1537,oax,20,551,551 Tlacolula de Matamoros,12733,5869,6864
1538,oax,20,552,552 Tlacotepec Plumas,572,275,297
1539,oax,20,553,553 Tlalixtac de Cabrera,6042,2929,3113
1540,oax,20,554,554 Totontepec Villa de Morelos,5438,2655,2783
1541,oax,20,555,555 Trinidad Zaachila,2833,1351,1482
1542,oax,20,556,556 Trinidad Vista Hermosa,393,188,205
1543,oax,20,557,557 Unión Hidalgo,12910,6340,6570
1544,oax,20,558,558 Valerio Trujano,1631,787,844
1545,oax,20,559,559 San Juan Bautista Valle Nacional,22276,11215,11061
1546,oax,20,560,560 Villa Díaz Ordaz,5791,2774,3017
1547,oax,20,561,561 Yaxe,2003,984,1019
1548,oax,20,562,562 Magdalena Yodocono de Porfirio Díaz,1447,690,757
1549,oax,20,563,563 Yogana,1807,874,933
1550,oax,20,564,564 Yutanduchi de Guerrero,1313,629,684
1551,oax,20,565,565 Villa de Zaachila,15512,7352,8160
1552,oax,20,566,566 Zapotitlán del Río,2688,1321,1367
1553,oax,20,567,567 Zapotitlán Lagunas,2915,1348,1567
1554,oax,20,568,568 Zapotitlán Palmas,1551,759,792
1555,oax,20,569,569 Santa Inés de Zaragoza,2061,1017,1044
1556,oax,20,570,570 Zimatlán de Álvarez,16311,7871,8440
1557,pue,21,0,Total Entidad,4624365,2253476,2370889
1558,pue,21,1,001 Acajete,47253,23031,24222
1559,pue,21,2,002 Acateno,8981,4574,4407
1560,pue,21,3,003 Acatlán,31814,14805,17009
1561,pue,21,4,004 Acatzingo,36660,18165,18495
1562,pue,21,5,005 Acteopan,3149,1551,1598
1563,pue,21,6,006 Ahuacatlán,11558,5660,5898
1564,pue,21,7,007 Ahuatlán,3296,1625,1671
1565,pue,21,8,008 Ahuazotepec,8264,4070,4194
1566,pue,21,9,009 Ahuehuetitla,2523,1172,1351
1567,pue,21,10,010 Ajalpan,42183,20812,21371
1568,pue,21,11,011 Albino Zertuche,1665,776,889
1569,pue,21,12,012 Aljojuca,6589,3183,3406
1570,pue,21,13,013 Altepexi,13741,6737,7004
1571,pue,21,14,014 Amixtlán,4273,2108,2165
1572,pue,21,15,015 Amozoc,54699,26978,27721
1573,pue,21,16,016 Aquixtla,7541,3760,3781
1574,pue,21,17,017 Atempan,17955,8911,9044
1575,pue,21,18,018 Atexcal,3026,1486,1540
1576,pue,21,19,019 Atlixco,112480,53510,58970
1577,pue,21,20,020 Atoyatempan,5136,2530,2606
1578,pue,21,21,021 Atzala,1195,612,583
1579,pue,21,22,022 Atzitzihuacán,11177,5404,5773
1580,pue,21,23,023 Atzitzintla,7361,3709,3652
1581,pue,21,24,024 Axutla,1114,520,594
1582,pue,21,25,025 Ayotoxco de Guerrero,7093,3590,3503
1583,pue,21,26,026 Calpan,12625,6133,6492
1584,pue,21,27,027 Caltepec,4837,2279,2558
1585,pue,21,28,028 Camocuautla,2012,1016,996
1586,pue,21,29,029 Caxhuacan,3501,1759,1742
1587,pue,21,30,030 Coatepec,867,426,441
1588,pue,21,31,031 Coatzingo,3164,1507,1657
1589,pue,21,32,032 Cohetzala,1806,878,928
1590,pue,21,33,033 Cohuecan,4538,2246,2292
1591,pue,21,34,034 Coronango,25179,12453,12726
1592,pue,21,35,035 Coxcatlán,17399,8634,8765
1593,pue,21,36,036 Coyomeapan,11229,5490,5739
1594,pue,21,37,037 Coyotepec,2145,999,1146
1595,pue,21,38,038 Cuapiaxtla de Madero,5662,2794,2868
1596,pue,21,39,039 Cuautempan,8524,4181,4343
1597,pue,21,40,040 Cuautinchán,6323,3142,3181
1598,pue,21,41,041 Cuautlancingo,39514,19441,20073
1599,pue,21,42,042 Cuayuca de Andrade,3694,1740,1954
1600,pue,21,43,043 Cuetzalan del Progreso,39866,19936,19930
1601,pue,21,44,044 Cuyoaco,13754,6869,6885
1602,pue,21,45,045 Chalchicomula de Sesma,37089,18256,18833
1603,pue,21,46,046 Chapulco,4769,2303,2466
1604,pue,21,47,047 Chiautla,19738,9529,10209
1605,pue,21,48,048 Chiautzingo,16951,8236,8715
1606,pue,21,49,049 Chiconcuautla,11481,5657,5824
1607,pue,21,50,050 Chichiquila,18312,9136,9176
1608,pue,21,51,051 Chietla,35859,17477,18382
1609,pue,21,52,052 Chigmecatitlán,1104,498,606
1610,pue,21,53,053 Chignahuapan,46208,23180,23028
1611,pue,21,54,054 Chignautla,18275,9223,9052
1612,pue,21,55,055 Chila,4570,2170,2400
1613,pue,21,56,056 Chila de la Sal,1573,712,861
1614,pue,21,57,057 Honey,6485,3189,3296
1615,pue,21,58,058 Chilchotla,17444,9028,8416
1616,pue,21,59,059 Chinantla,2356,1077,1279
1617,pue,21,60,060 Domingo Arenas,5011,2491,2520
1618,pue,21,61,061 Eloxochitlán,9116,4605,4511
1619,pue,21,62,062 Epatlán,4872,2348,2524
1620,pue,21,63,063 Esperanza,12115,5970,6145
1621,pue,21,64,064 Francisco Z. Mena,15976,7995,7981
1622,pue,21,65,065 General Felipe Angeles,15047,7303,7744
1623,pue,21,66,066 Guadalupe,7376,3409,3967
1624,pue,21,67,067 Guadalupe Victoria,13961,6844,7117
1625,pue,21,68,068 Hermenegildo Galeana,7215,3654,3561
1626,pue,21,69,069 Huaquechula,26114,12239,13875
1627,pue,21,70,070 Huatlatlauca,7338,3326,4012
1628,pue,21,71,071 Huauchinango,75169,36452,38717
1629,pue,21,72,072 Huehuetla,13872,6977,6895
1630,pue,21,73,073 Huehuetlán el Chico,9088,4444,4644
1631,pue,21,74,074 Huejotzingo,47301,23275,24026
1632,pue,21,75,075 Hueyapan,9018,4539,4479
1633,pue,21,76,076 Hueytamalco,25108,12789,12319
1634,pue,21,77,077 Hueytlalpan,4556,2359,2197
1635,pue,21,78,078 Huitzilan de Serdán,10512,5298,5214
1636,pue,21,79,079 Huitziltepec,4258,2105,2153
1637,pue,21,80,080 Atlequizayan,2531,1254,1277
1638,pue,21,81,081 Ixcamilpa de Guerrero,4302,2113,2189
1639,pue,21,82,082 Ixcaquixtla,6153,2966,3187
1640,pue,21,83,083 Ixtacamaxtitlán,28294,14368,13926
1641,pue,21,84,084 Ixtepec,5199,2590,2609
1642,pue,21,85,085 Izúcar de Matamoros,66182,31519,34663
1643,pue,21,86,086 Jalpan,12082,6106,5976
1644,pue,21,87,087 Jolalpan,11887,5750,6137
1645,pue,21,88,088 Jonotla,4543,2275,2268
1646,pue,21,89,089 Jopala,11570,5803,5767
1647,pue,21,90,090 Juan C. Bonilla,13832,6857,6975
1648,pue,21,91,091 Juan Galindo,8513,4008,4505
1649,pue,21,92,092 Juan N. Méndez,4554,2241,2313
1650,pue,21,93,093 Lafragua,10551,5325,5226
1651,pue,21,94,094 Libres,24337,12051,12286
1652,pue,21,95,095 Magdalena Tlatlauquitepec,419,205,214
1653,pue,21,96,096 Mazapiltepec de Juárez,2358,1186,1172
1654,pue,21,97,097 Mixtla,1906,891,1015
1655,pue,21,98,098 Molcaxac,5995,2854,3141
1656,pue,21,99,099 Cañada Morelos,16030,7906,8124
1657,pue,21,100,100 Naupan,9519,4597,4922
1658,pue,21,101,101 Nauzontla,3448,1682,1766
1659,pue,21,102,102 Nealtican,9555,4614,4941
1660,pue,21,103,103 Nicolás Bravo,4887,2425,2462
1661,pue,21,104,104 Nopalucan,16974,8379,8595
1662,pue,21,105,105 Ocotepec,4785,2374,2411
1663,pue,21,106,106 Ocoyucan,19959,9753,10206
1664,pue,21,107,107 Olintla,10363,5150,5213
1665,pue,21,108,108 Oriental,13240,6492,6748
1666,pue,21,109,109 Pahuatlán,17783,8856,8927
1667,pue,21,110,110 Palmar de Bravo,31583,15722,15861
1668,pue,21,111,111 Pantepec,17387,8647,8740
1669,pue,21,112,112 Petlalcingo,9319,4375,4944
1670,pue,21,113,113 Piaxtla,5301,2522,2779
1671,pue,21,114,114 Puebla,1222569,587326,635243
1672,pue,21,115,115 Quecholac,34442,16992,17450
1673,pue,21,116,116 Quimixtlán,18211,9216,8995
1674,pue,21,117,117 Rafael Lara Grajales,13398,6493,6905
1675,pue,21,118,118 Reyes de Juárez,18761,9197,9564
1676,pue,21,119,119 San Andrés Cholula,45872,22371,23501
1677,pue,21,120,120 San Antonio Cañada,3833,1794,2039
1678,pue,21,121,121 San Diego la Mesa Tochimiltzingo,1214,615,599
1679,pue,21,122,122 San Felipe Teotlalcingo,8382,4137,4245
1680,pue,21,123,123 San Felipe Tepatlán,4353,2200,2153
1681,pue,21,124,124 San Gabriel Chilac,11790,5739,6051
1682,pue,21,125,125 San Gregorio Atzompa,6407,3153,3254
1683,pue,21,126,126 San Jerónimo Tecuanipan,4819,2372,2447
1684,pue,21,127,127 San Jerónimo Xayacatlán,4229,1983,2246
1685,pue,21,128,128 San José Chiapa,6259,3147,3112
1686,pue,21,129,129 San José Miahuatlán,10285,4980,5305
1687,pue,21,130,130 San Juan Atenco,3715,1815,1900
1688,pue,21,131,131 San Juan Atzompa,616,327,289
1689,pue,21,132,132 San Martín Texmelucan,111737,54335,57402
1690,pue,21,133,133 San Martín Totoltepec,898,436,462
1691,pue,21,134,134 San Matías Tlalancaleca,15482,7695,7787
1692,pue,21,135,135 San Miguel Ixitlán,651,311,340
1693,pue,21,136,136 San Miguel Xoxtla,8589,4241,4348
1694,pue,21,137,137 San Nicolás Buenos Aires,8094,4060,4034
1695,pue,21,138,138 San Nicolás de los Ranchos,10173,5027,5146
1696,pue,21,139,139 San Pablo Anicano,3472,1671,1801
1697,pue,21,140,140 San Pedro Cholula,89782,43778,46004
1698,pue,21,141,141 San Pedro Yeloixtlahuaca,3490,1671,1819
1699,pue,21,142,142 San Salvador el Seco,23294,11547,11747
1700,pue,21,143,143 San Salvador el Verde,21075,10507,10568
1701,pue,21,144,144 San Salvador Huixcolotla,8640,4270,4370
1702,pue,21,145,145 San Sebastián Tlacotepec,11683,5759,5924
1703,pue,21,146,146 Santa Catarina Tlaltempan,697,339,358
1704,pue,21,147,147 Santa Inés Ahuatempan,5235,2535,2700
1705,pue,21,148,148 Santa Isabel Cholula,8188,3992,4196
1706,pue,21,149,149 Santiago Miahuatlán,11708,5635,6073
1707,pue,21,150,150 Huehuetlán el Grande,7102,3455,3647
1708,pue,21,151,151 Santo Tomás Hueyotlipan,6582,3191,3391
1709,pue,21,152,152 Soltepec,10906,5453,5453
1710,pue,21,153,153 Tecali de Herrera,15610,7735,7875
1711,pue,21,154,154 Tecamachalco,52764,25775,26989
1712,pue,21,155,155 Tecomatlán,5190,2490,2700
1713,pue,21,156,156 Tehuacán,190468,91991,98477
1714,pue,21,157,157 Tehuitzingo,12044,5678,6366
1715,pue,21,158,158 Tenampulco,7002,3535,3467
1716,pue,21,159,159 Teopantlán,5203,2393,2810
1717,pue,21,160,160 Teotlalco,3076,1547,1529
1718,pue,21,161,161 Tepanco de López,14714,7061,7653
1719,pue,21,162,162 Tepango de Rodríguez,3337,1659,1678
1720,pue,21,163,163 Tepatlaxco de Hidalgo,14275,6941,7334
1721,pue,21,164,164 Tepeaca,56665,27595,29070
1722,pue,21,165,165 Tepemaxalco,1170,594,576
1723,pue,21,166,166 Tepeojuma,8378,3882,4496
1724,pue,21,167,167 Tepetzintla,9182,4449,4733
1725,pue,21,168,168 Tepexco,5394,2587,2807
1726,pue,21,169,169 Tepexi de Rodríguez,16812,8308,8504
1727,pue,21,170,170 Tepeyahualco,14803,7403,7400
1728,pue,21,171,171 Tepeyahualco de Cuauhtémoc,2710,1345,1365
1729,pue,21,172,172 Tetela de Ocampo,24106,11860,12246
1730,pue,21,173,173 Teteles de Avila Castillo,4531,2133,2398
1731,pue,21,174,174 Teziutlán,71228,34250,36978
1732,pue,21,175,175 Tianguismanalco,9122,4331,4791
1733,pue,21,176,176 Tilapa,7872,3816,4056
1734,pue,21,177,177 Tlacotepec de Benito Juárez,36606,18096,18510
1735,pue,21,178,178 Tlacuilotepec,16183,8181,8002
1736,pue,21,179,179 Tlachichuca,26366,13196,13170
1737,pue,21,180,180 Tlahuapan,29642,15008,14634
1738,pue,21,181,181 Tlaltenango,5078,2517,2561
1739,pue,21,182,182 Tlanepantla,3638,1751,1887
1740,pue,21,183,183 Tlaola,15822,7872,7950
1741,pue,21,184,184 Tlapacoya,5914,2969,2945
1742,pue,21,185,185 Tlapanalá,7950,3762,4188
1743,pue,21,186,186 Tlatlauquitepec,45036,22002,23034
1744,pue,21,187,187 Tlaxco,5743,2919,2824
1745,pue,21,188,188 Tochimilco,15795,7686,8109
1746,pue,21,189,189 Tochtepec,16060,7973,8087
1747,pue,21,190,190 Totoltepec de Guerrero,1066,506,560
1748,pue,21,191,191 Tulcingo,8707,4036,4671
1749,pue,21,192,192 Tuzamapan de Galeana,5679,2822,2857
1750,pue,21,193,193 Tzicatlacoyan,5943,2937,3006
1751,pue,21,194,194 Venustiano Carranza,25066,12262,12804
1752,pue,21,195,195 Vicente Guerrero,20345,10204,10141
1753,pue,21,196,196 Xayacatlán de Bravo,1419,645,774
1754,pue,21,197,197 Xicotepec,64815,31720,33095
1755,pue,21,198,198 Xicotlán,1147,546,601
1756,pue,21,199,199 Xiutetelco,27728,13793,13935
1757,pue,21,200,200 Xochiapulco,4275,2139,2136
1758,pue,21,201,201 Xochiltepec,3145,1489,1656
1759,pue,21,202,202 Xochitlán de Vicente Suárez,11588,5828,5760
1760,pue,21,203,203 Xochitlán Todos Santos,4569,2189,2380
1761,pue,21,204,204 Yaonáhuac,6392,3217,3175
1762,pue,21,205,205 Yehualtepec,17448,8700,8748
1763,pue,21,206,206 Zacapala,4269,2023,2246
1764,pue,21,207,207 Zacapoaxtla,45546,22469,23077
1765,pue,21,208,208 Zacatlán,62788,30605,32183
1766,pue,21,209,209 Zapotitlán,8132,3957,4175
1767,pue,21,210,210 Zapotitlán de Méndez,4857,2447,2410
1768,pue,21,211,211 Zaragoza,12572,6169,6403
1769,pue,21,212,212 Zautla,19048,9184,9864
1770,pue,21,213,213 Zihuateutla,10983,5567,5416
1771,pue,21,214,214 Zinacatepec,11976,5721,6255
1772,pue,21,215,215 Zongozotla,3804,1852,1952
1773,pue,21,216,216 Zoquiapan,2951,1454,1497
1774,pue,21,217,217 Zoquitlán,18042,8789,9253
1775,que,22,0,Total Entidad,1250476,615484,634992
1776,que,22,1,001 Amealco de Bonfil,50407,24917,25490
1777,que,22,2,002 Pinal de Amoles,26864,13398,13466
1778,que,22,3,003 Arroyo Seco,13203,6578,6625
1779,que,22,4,004 Cadereyta de Montes,51641,25591,26050
1780,que,22,5,005 Colón,43443,21794,21649
1781,que,22,6,006 Corregidora,59855,29469,30386
1782,que,22,7,007 Ezequiel Montes,25605,12230,13375
1783,que,22,8,008 Huimilpan,26809,13450,13359
1784,que,22,9,009 Jalpan de Serra,21671,10755,10916
1785,que,22,10,010 Landa de Matamoros,18848,9526,9322
1786,que,22,11,011 Marqués,60680,30673,30007
1787,que,22,12,012 Pedro Escobedo,46270,23121,23149
1788,que,22,13,013 Peñamiller,17748,8982,8766
1789,que,22,14,014 Querétaro,559222,272512,286710
1790,que,22,15,015 San Joaquín,7490,3650,3840
1791,que,22,16,016 San Juan del Río,154922,76392,78530
1792,que,22,17,017 Tequisquiapan,45779,22637,23142
1793,que,22,18,018 Tolimán,20019,9809,10210
1794,qui,23,0,Total Entidad,703536,361459,342077
1795,qui,23,1,001 Cozumel,48385,25097,23288
1796,qui,23,2,002 Felipe Carrillo Puerto,56001,28663,27338
1797,qui,23,3,003 Isla Mujeres,8750,4570,4180
1798,qui,23,4,004 Othón P. Blanco,202046,102518,99528
1799,qui,23,5,005 Benito Juárez,311696,160505,151191
1800,qui,23,6,006 José María Morelos,29604,15321,14283
1801,qui,23,7,007 Lázaro Cárdenas,18307,9532,8775
1802,qui,23,8,008 Solidaridad,28747,15253,13494
1803,san,24,0,Total Entidad,2200763,1087500,1113263
1804,san,24,1,001 Ahualulco,18745,9052,9693
1805,san,24,2,002 Alaquines,8487,4340,4147
1806,san,24,3,003 Aquismón,38063,19533,18530
1807,san,24,4,004 Armadillo de los Infante,5523,2822,2701
1808,san,24,5,005 Cárdenas,18231,8780,9451
1809,san,24,6,006 Catorce,11138,5696,5442
1810,san,24,7,007 Cedral,17051,8654,8397
1811,san,24,8,008 Cerritos,21308,10178,11130
1812,san,24,9,009 Cerro de San Pedro,3086,1539,1547
1813,san,24,10,010 Ciudad del Maíz,30268,15451,14817
1814,san,24,11,011 Ciudad Fernández,38351,18971,19380
1815,san,24,12,012 Tancanhuitz de Santos,19572,9849,9723
1816,san,24,13,013 Ciudad Valles,143277,70658,72619
1817,san,24,14,014 Coxcatlán,16799,8525,8274
1818,san,24,15,015 Charcas,21401,10723,10678
1819,san,24,16,016 Ebano,38989,19605,19384
1820,san,24,17,017 Guadalcázar,26974,13795,13179
1821,san,24,18,018 Huehuetlán,12504,6254,6250
1822,san,24,19,019 Lagunillas,7213,3615,3598
1823,san,24,20,020 Matehuala,75802,36928,38874
1824,san,24,21,021 Mexquitic de Carmona,47142,23316,23826
1825,san,24,22,022 Moctezuma,18876,9234,9642
1826,san,24,23,023 Rayón,16763,8385,8378
1827,san,24,24,024 Rioverde,88922,43780,45142
1828,san,24,25,025 Salinas,23960,11772,12188
1829,san,24,26,026 San Antonio,8525,4370,4155
1830,san,24,27,027 San Ciro de Acosta,10824,5255,5569
1831,san,24,28,028 San Luis Potosí,625466,301408,324058
1832,san,24,29,029 San Martín Chalchicuautla,22968,11841,11127
1833,san,24,30,030 San Nicolás Tolentino,7433,3666,3767
1834,san,24,31,031 Santa Catarina,10642,5367,5275
1835,san,24,32,032 Santa María del Río,37448,18303,19145
1836,san,24,33,033 Santo Domingo,13181,6719,6462
1837,san,24,34,034 San Vicente Tancuayalab,13604,6978,6626
1838,san,24,35,035 Soledad de Graciano Sánchez,156498,76036,80462
1839,san,24,36,036 Tamasopo,27013,13833,13180
1840,san,24,37,037 Tamazunchale,83458,42000,41458
1841,san,24,38,038 Tampacán,16318,8452,7866
1842,san,24,39,039 Tampamolón Corona,13311,6825,6486
1843,san,24,40,040 Tamuín,36543,18280,18263
1844,san,24,41,041 Tanlajás,16634,8598,8036
1845,san,24,42,042 Tanquián de Escobedo,13162,6619,6543
1846,san,24,43,043 Tierra Nueva,9669,4597,5072
1847,san,24,44,044 Vanegas,8179,4225,3954
1848,san,24,45,045 Venado,14794,7508,7286
1849,san,24,46,046 Villa de Arriaga,13933,7032,6901
1850,san,24,47,047 Villa de Guadalupe,10907,5563,5344
1851,san,24,48,048 Villa de la Paz,5060,2514,2546
1852,san,24,49,049 Villa de Ramos,32484,16303,16181
1853,san,24,50,050 Villa de Reyes,38926,19442,19484
1854,san,24,51,051 Villa Hidalgo,15724,7978,7746
1855,san,24,52,052 Villa Juárez,11867,5865,6002
1856,san,24,53,053 Axtla de Terrazas,31310,15895,15415
1857,san,24,54,054 Xilitla,46757,24050,22707
1858,san,24,55,055 Zaragoza,21235,10608,10627
1859,san,24,56,056 Villa de Arista,13487,6905,6582
1860,san,24,57,057 Matlapa,26703,13693,13010
1861,san,24,58,058 Naranjo,18255,9317,8938
1862,sin,25,0,Total Entidad,2425675,1216415,1209260
1863,sin,25,1,001 Ahome,340454,169439,171015
1864,sin,25,2,002 Angostura,47095,23737,23358
1865,sin,25,3,003 Badiraguato,40298,21005,19293
1866,sin,25,4,004 Concordia,27783,14244,13539
1867,sin,25,5,005 Cosalá,17641,9086,8555
1868,sin,25,6,006 Culiacán,696262,345214,351048
1869,sin,25,7,007 Choix,36532,19169,17363
1870,sin,25,8,008 Elota,34490,17901,16589
1871,sin,25,9,009 Escuinapa,49474,25083,24391
1872,sin,25,10,010 Fuerte,90182,46020,44162
1873,sin,25,11,011 Guasave,264225,132214,132011
1874,sin,25,12,012 Mazatlán,357619,176850,180769
1875,sin,25,13,013 Mocorito,52026,26837,25189
1876,sin,25,14,014 Rosario,49240,25342,23898
1877,sin,25,15,015 Salvador Alvarado,72605,35884,36721
1878,sin,25,16,016 San Ignacio,27101,14325,12776
1879,sin,25,17,017 Sinaloa,90283,46248,44035
1880,sin,25,18,018 Navolato,132365,67817,64548
1881,son,26,0,Total Entidad,2085536,1048933,1036603
1882,son,26,1,001 Aconchi,2264,1168,1096
1883,son,26,2,002 Agua Prieta,56289,28566,27723
1884,son,26,3,003 Alamos,26075,13595,12480
1885,son,26,4,004 Altar,7134,3757,3377
1886,son,26,5,005 Arivechi,1548,813,735
1887,son,26,6,006 Arizpe,3641,1887,1754
1888,son,26,7,007 Atil,777,393,384
1889,son,26,8,008 Bacadéhuachi,1380,725,655
1890,son,26,9,009 Bacanora,1237,678,559
1891,son,26,10,010 Bacerac,1535,802,733
1892,son,26,11,011 Bacoachi,1693,875,818
1893,son,26,12,012 Bácum,21662,11015,10647
1894,son,26,13,013 Banámichi,1600,815,785
1895,son,26,14,014 Baviácora,3692,1928,1764
1896,son,26,15,015 Bavispe,1396,748,648
1897,son,26,16,016 Benjamín Hill,6119,3132,2987
1898,son,26,17,017 Caborca,64605,32821,31784
1899,son,26,18,018 Cajeme,345222,170782,174440
1900,son,26,19,019 Cananea,29315,14681,14634
1901,son,26,20,020 Carbó,4994,2603,2391
1902,son,26,21,021 Colorada,2390,1347,1043
1903,son,26,22,022 Cucurpe,913,517,396
1904,son,26,23,023 Cumpas,6639,3460,3179
1905,son,26,24,024 Divisaderos,807,403,404
1906,son,26,25,025 Empalme,48607,24408,24199
1907,son,26,26,026 Etchojoa,79798,40644,39154
1908,son,26,27,027 Fronteras,6671,3483,3188
1909,son,26,28,028 Granados,1259,651,608
1910,son,26,29,029 Guaymas,134625,67399,67226
1911,son,26,30,030 Hermosillo,559154,279421,279733
1912,son,26,31,031 Huachinera,1290,657,633
1913,son,26,32,032 Huásabas,1024,542,482
1914,son,26,33,033 Huatabampo,75706,38303,37403
1915,son,26,34,034 Huépac,1131,584,547
1916,son,26,35,035 Imuris,9028,4581,4447
1917,son,26,36,036 Magdalena,22206,11110,11096
1918,son,26,37,037 Mazatán,1835,967,868
1919,son,26,38,038 Moctezuma,4095,2102,1993
1920,son,26,39,039 Naco,4912,2516,2396
1921,son,26,40,040 Nácori Chico,2417,1301,1116
1922,son,26,41,041 Nacozari de García,14195,7620,6575
1923,son,26,42,042 Navojoa,136162,67467,68695
1924,son,26,43,043 Nogales,133491,67428,66063
1925,son,26,44,044 Onavas,501,275,226
1926,son,26,45,045 Opodepe,3069,1645,1424
1927,son,26,46,046 Oquitoa,416,219,197
1928,son,26,47,047 Pitiquito,8957,4686,4271
1929,son,26,48,048 Puerto Peñasco,27169,13762,13407
1930,son,26,49,049 Quiriego,3820,2075,1745
1931,son,26,50,050 Rayón,1695,933,762
1932,son,26,51,051 Rosario,5962,3155,2807
1933,son,26,52,052 Sahuaripa,7222,3790,3432
1934,son,26,53,053 San Felipe de Jesús,403,209,194
1935,son,26,54,054 San Javier,306,163,143
1936,son,26,55,055 San Luis Río Colorado,133140,66980,66160
1937,son,26,56,056 San Miguel de Horcasitas,4439,2316,2123
1938,son,26,57,057 San Pedro de la Cueva,1890,1010,880
1939,son,26,58,058 Santa Ana,13374,6673,6701
1940,son,26,59,059 Santa Cruz,1407,733,674
1941,son,26,60,060 Sáric,2287,1212,1075
1942,son,26,61,061 Soyopa,1931,1078,853
1943,son,26,62,062 Suaqui Grande,1313,693,620
1944,son,26,63,063 Tepache,1611,835,776
1945,son,26,64,064 Trincheras,1900,1004,896
1946,son,26,65,065 Tubutama,1893,986,907
1947,son,26,66,066 Ures,10206,5296,4910
1948,son,26,67,067 Villa Hidalgo,1955,1022,933
1949,son,26,68,068 Villa Pesqueira,1701,930,771
1950,son,26,69,069 Yécora,6114,3237,2877
1951,son,26,70,070 General Plutarco Elías Calles,10322,5321,5001
1952,tab,27,0,Total Entidad,1748769,872243,876526
1953,tab,27,1,001 Balancán,54089,27560,26529
1954,tab,27,2,002 Cárdenas,204810,102350,102460
1955,tab,27,3,003 Centla,77543,39034,38509
1956,tab,27,4,004 Centro,465449,227662,237787
1957,tab,27,5,005 Comalcalco,156334,78164,78170
1958,tab,27,6,006 Cunduacán,97698,49097,48601
1959,tab,27,7,007 Emiliano Zapata,25500,12467,13033
1960,tab,27,8,008 Huimanguillo,154577,78396,76181
1961,tab,27,9,009 Jalapa,31304,15855,15449
1962,tab,27,10,010 Jalpa de Méndez,64282,32293,31989
1963,tab,27,11,011 Jonuta,24792,12661,12131
1964,tab,27,12,012 Macuspana,123024,61391,61633
1965,tab,27,13,013 Nacajuca,68149,34269,33880
1966,tab,27,14,014 Paraíso,65266,32642,32624
1967,tab,27,15,015 Tacotalpa,37857,19244,18613
1968,tab,27,16,016 Teapa,42657,21381,21276
1969,tab,27,17,017 Tenosique,55438,27777,27661
1970,tam,28,0,Total Entidad,2527328,1254700,1272628
1971,tam,28,1,001 Abasolo,14110,7282,6828
1972,tam,28,2,002 Aldama,28781,14970,13811
1973,tam,28,3,003 Altamira,113810,57395,56415
1974,tam,28,4,004 Antiguo Morelos,9816,5024,4792
1975,tam,28,5,005 Burgos,5953,3074,2879
1976,tam,28,6,006 Bustamante,8198,4304,3894
1977,tam,28,7,007 Camargo,15309,7740,7569
1978,tam,28,8,008 Casas,4959,2702,2257
1979,tam,28,9,009 Ciudad Madero,171091,82095,88996
1980,tam,28,10,010 Cruillas,2476,1282,1194
1981,tam,28,11,011 Gómez Farías,9132,4754,4378
1982,tam,28,12,012 González,42371,21510,20861
1983,tam,28,13,013 Güémez,16014,8424,7590
1984,tam,28,14,014 Guerrero,4007,2142,1865
1985,tam,28,15,015 Gustavo Díaz Ordaz,15689,7903,7786
1986,tam,28,16,016 Hidalgo,26297,13740,12557
1987,tam,28,17,017 Jaumave,13504,6912,6592
1988,tam,28,18,018 Jiménez,8947,4576,4371
1989,tam,28,19,019 Llera,19274,10092,9182
1990,tam,28,20,020 Mainero,3143,1653,1490
1991,tam,28,21,021 Mante,116451,57435,59016
1992,tam,28,22,022 Matamoros,363487,178906,184581
1993,tam,28,23,023 Méndez,5924,3021,2903
1994,tam,28,24,024 Mier,6270,3192,3078
1995,tam,28,25,025 Miguel Alemán,22403,11314,11089
1996,tam,28,26,026 Miquihuana,3494,1895,1599
1997,tam,28,27,027 Nuevo Laredo,275060,136661,138399
1998,tam,28,28,028 Nuevo Morelos,3332,1736,1596
1999,tam,28,29,029 Ocampo,14504,7567,6937
2000,tam,28,30,030 Padilla,14430,7419,7011
2001,tam,28,31,031 Palmillas,1862,968,894
2002,tam,28,32,032 Reynosa,337053,167721,169332
2003,tam,28,33,033 Río Bravo,100373,50240,50133
2004,tam,28,34,034 San Carlos,10469,5445,5024
2005,tam,28,35,035 San Fernando,56649,28947,27702
2006,tam,28,36,036 San Nicolás,1030,514,516
2007,tam,28,37,037 Soto la Marina,24237,12900,11337
2008,tam,28,38,038 Tampico,278933,133519,145414
2009,tam,28,39,039 Tula,28639,14721,13918
2010,tam,28,40,040 Valle Hermoso,55286,27367,27919
2011,tam,28,41,041 Victoria,243960,119949,124011
2012,tam,28,42,042 Villagrán,7578,3983,3595
2013,tam,28,43,043 Xicoténcatl,23023,11706,11317
2014,tla,29,0,Total Entidad,883924,435390,448534
2015,tla,29,1,001 Amaxac de Guerrero,7120,3554,3566
2016,tla,29,2,002 Apetatitlán de Antonio Carvajal,10894,5403,5491
2017,tla,29,3,003 Atlangatepec,4666,2330,2336
2018,tla,29,4,004 Altzayanca,12563,6378,6185
2019,tla,29,5,005 Apizaco,62617,30269,32348
2020,tla,29,6,006 Calpulalpan,34779,17147,17632
2021,tla,29,7,007 Carmen Tequexquitla,11817,5928,5889
2022,tla,29,8,008 Cuapiaxtla,10089,5099,4990
2023,tla,29,9,009 Cuaxomulco,3887,1971,1916
2024,tla,29,10,010 Chiautempan,53241,25861,27380
2025,tla,29,11,011 Muñoz de Domingo Arenas,3781,1906,1875
2026,tla,29,12,012 Españita,6859,3522,3337
2027,tla,29,13,013 Huamantla,59122,29039,30083
2028,tla,29,14,014 Hueyotlipan,12422,6339,6083
2029,tla,29,15,015 Ixtacuixtla de Mariano Matamoros,28789,14288,14501
2030,tla,29,16,016 Ixtenco,5696,2713,2983
2031,tla,29,17,017 Mazatecochco de José María Morelos,7407,3696,3711
2032,tla,29,18,018 Contla de Juan Cuamatzi,26740,13384,13356
2033,tla,29,19,019 Tepetitla de Lardizábal,12771,6286,6485
2034,tla,29,20,020 Sanctórum de Lázaro Cárdenas,6690,3329,3361
2035,tla,29,21,021 Nanacamilpa de Mariano Arista,14510,7276,7234
2036,tla,29,22,022 Acuamanala de Miguel Hidalgo,4254,2179,2075
2037,tla,29,23,023 Natívitas,20250,9903,10347
2038,tla,29,24,024 Panotla,20776,10255,10521
2039,tla,29,25,025 San Pablo del Monte,48988,24246,24742
2040,tla,29,26,026 Santa Cruz Tlaxcala,11688,5763,5925
2041,tla,29,27,027 Tenancingo,9597,4687,4910
2042,tla,29,28,028 Teolocholco,16095,7867,8228
2043,tla,29,29,029 Tepeyanco,8672,4143,4529
2044,tla,29,30,030 Terrenate,10505,5366,5139
2045,tla,29,31,031 Tetla de la Solidaridad,19722,9756,9966
2046,tla,29,32,032 Tetlatlahuca,10230,5072,5158
2047,tla,29,33,033 Tlaxcala,63423,30789,32634
2048,tla,29,34,034 Tlaxco,30766,15200,15566
2049,tla,29,35,035 Tocatlán,4213,2076,2137
2050,tla,29,36,036 Totolac,14962,7226,7736
2051,tla,29,37,037 Zitlaltepec de Trinidad Sánchez Santos,8095,3950,4145
2052,tla,29,38,038 Tzompantepec,7551,3776,3775
2053,tla,29,39,039 Xalostoc,15490,7875,7615
2054,tla,29,40,040 Xaltocan,6911,3451,3460
2055,tla,29,41,041 Papalotla de Xicohténcatl,19901,9709,10192
2056,tla,29,42,042 Xicohtzinco,9485,4563,4922
2057,tla,29,43,043 Yauhquemecan,16844,8443,8401
2058,tla,29,44,044 Zacatelco,30574,14883,15691
2059,tla,29,45,045 Benito Juárez,4432,2181,2251
2060,tla,29,46,046 Emiliano Zapata,3059,1548,1511
2061,tla,29,47,047 Lázaro Cárdenas,2142,1112,1030
2062,tla,29,48,048 Magdalena Tlaltelulco,12174,5931,6243
2063,tla,29,49,049 San Damián Texoloc,4102,2036,2066
2064,tla,29,50,050 San Francisco Tetlanohcan,8422,4122,4300
2065,tla,29,51,051 San Jerónimo Zacualpan,3196,1552,1644
2066,tla,29,52,052 San José Teacalco,4600,2239,2361
2067,tla,29,53,053 San Juan Huactzinco,5510,2616,2894
2068,tla,29,54,054 San Lorenzo Axocomanitla,4264,2068,2196
2069,tla,29,55,055 San Lucas Tecopilco,2820,1375,1445
2070,tla,29,56,056 Santa Ana Nopalucan,5302,2643,2659
2071,tla,29,57,057 Santa Apolonia Teacalco,3707,1796,1911
2072,tla,29,58,058 Santa Catarina Ayometla,6998,3458,3540
2073,tla,29,59,059 Santa Cruz Quilehtla,4573,2274,2299
2074,tla,29,60,060 Santa Isabel Xiloxoxtla,3171,1543,1628
2075,ver,30,0,Total Entidad,6737324,3323880,3413444
2076,ver,30,1,001 Acajete,7161,3733,3428
2077,ver,30,2,002 Acatlán,2644,1322,1322
2078,ver,30,3,003 Acayucan,79509,39356,40153
2079,ver,30,4,004 Actopan,41884,21487,20397
2080,ver,30,5,005 Acula,4773,2441,2332
2081,ver,30,6,006 Acultzingo,16048,7990,8058
2082,ver,30,7,007 Camarón de Tejeda,5716,2918,2798
2083,ver,30,8,008 Alpatláhuac,8985,4489,4496
2084,ver,30,9,009 Alto Lucero de Gutiérrez Barrios,27331,14076,13255
2085,ver,30,10,010 Altotonga,48827,24178,24649
2086,ver,30,11,011 Alvarado,48490,24485,24005
2087,ver,30,12,012 Amatitlán,7541,3760,3781
2088,ver,30,13,013 Amatlán Tuxpan,27096,13009,14087
2089,ver,30,14,014 Amatlán de los Reyes,36219,17806,18413
2090,ver,30,15,015 Ángel R. Cabada,34312,16974,17338
2091,ver,30,16,016 Antigua,23529,11533,11996
2092,ver,30,17,017 Apazapan,3952,2032,1920
2093,ver,30,18,018 Aquila,1624,790,834
2094,ver,30,19,019 Astacinga,5240,2572,2668
2095,ver,30,20,020 Atlahuilco,7295,3586,3709
2096,ver,30,21,021 Atoyac,23450,11636,11814
2097,ver,30,22,022 Atzacan,15518,7911,7607
2098,ver,30,23,023 Atzalan,46124,23652,22472
2099,ver,30,24,024 Tlaltetela,11904,6038,5866
2100,ver,30,25,025 Ayahualulco,20931,10747,10184
2101,ver,30,26,026 Banderilla,33798,16570,17228
2102,ver,30,27,027 Benito Juárez,15334,7531,7803
2103,ver,30,28,028 Boca del Río,135060,64191,70869
2104,ver,30,29,029 Calcahualco,10556,5361,5195
2105,ver,30,30,030 Camerino Z. Mendoza,37819,18165,19654
2106,ver,30,31,031 Carrillo Puerto,13992,7158,6834
2107,ver,30,32,032 Catemaco,44321,22193,22128
2108,ver,30,33,033 Cazones de Herrera,23621,11804,11817
2109,ver,30,34,034 Cerro Azul,27071,12886,14185
2110,ver,30,35,035 Citlaltépetl,11638,5862,5776
2111,ver,30,36,036 Coacoatzintla,6584,3279,3305
2112,ver,30,37,037 Coahuitlán,6553,3341,3212
2113,ver,30,38,038 Coatepec,70430,34460,35970
2114,ver,30,39,039 Coatzacoalcos,259096,127260,131836
2115,ver,30,40,040 Coatzintla,36902,18222,18680
2116,ver,30,41,041 Coetzala,1699,830,869
2117,ver,30,42,042 Colipa,6334,3236,3098
2118,ver,30,43,043 Comapa,14274,7419,6855
2119,ver,30,44,044 Córdoba,168760,80179,88581
2120,ver,30,45,045 Cosamaloapan,79845,39182,40663
2121,ver,30,46,046 Cosautlán de Carvajal,14268,7285,6983
2122,ver,30,47,047 Coscomatepec,38528,19374,19154
2123,ver,30,48,048 Cosoleacaque,64796,32300,32496
2124,ver,30,49,049 Cotaxtla,18179,9288,8891
2125,ver,30,50,050 Coxquihui,14225,7172,7053
2126,ver,30,51,051 Coyutla,20885,10383,10502
2127,ver,30,52,052 Cuichapa,11047,5452,5595
2128,ver,30,53,053 Cuitláhuac,22643,10913,11730
2129,ver,30,54,054 Chacaltianguis,12415,6290,6125
2130,ver,30,55,055 Chalma,13359,6722,6637
2131,ver,30,56,056 Chiconamel,6531,3315,3216
2132,ver,30,57,057 Chiconquiaco,11951,6172,5779
2133,ver,30,58,058 Chicontepec,60541,29929,30612
2134,ver,30,59,059 Chinameca,13912,6976,6936
2135,ver,30,60,060 Chinampa de Gorostiza,14557,7168,7389
2136,ver,30,61,061 Choapas,75372,37643,37729
2137,ver,30,62,062 Chocamán,14293,7163,7130
2138,ver,30,63,063 Chontla,15641,7961,7680
2139,ver,30,64,064 Chumatlán,3209,1588,1621
2140,ver,30,65,065 Emiliano Zapata,40411,20394,20017
2141,ver,30,66,066 Espinal,24869,12638,12231
2142,ver,30,67,067 Filomeno Mata,9746,4878,4868
2143,ver,30,68,068 Fortín,42990,20557,22433
2144,ver,30,69,069 Gutiérrez Zamora,28142,13574,14568
2145,ver,30,70,070 Hidalgotitlán,25831,13418,12413
2146,ver,30,71,071 Huatusco,41008,19998,21010
2147,ver,30,72,072 Huayacocotla,18846,9357,9489
2148,ver,30,73,073 Hueyapan de Ocampo,40396,20363,20033
2149,ver,30,74,074 Huiloapan de Cuauhtémoc,5570,2721,2849
2150,ver,30,75,075 Ignacio de la Llave,17867,8889,8978
2151,ver,30,76,076 Ilamatlán,12414,5971,6443
2152,ver,30,77,077 Isla,36899,18420,18479
2153,ver,30,78,078 Ixcatepec,13016,6442,6574
2154,ver,30,79,079 Ixhuacán de los Reyes,9104,4638,4466
2155,ver,30,80,080 Ixhuatlán del Café,17979,9085,8894
2156,ver,30,81,081 Ixhuatlancillo,9511,4613,4898
2157,ver,30,82,082 Ixhuatlán del Sureste,13746,7024,6722
2158,ver,30,83,083 Ixhuatlán de Madero,47295,23618,23677
2159,ver,30,84,084 Ixmatlahuacan,6332,3311,3021
2160,ver,30,85,085 Ixtaczoquitlán,52798,26056,26742
2161,ver,30,86,086 Jalacingo,29077,14631,14446
2162,ver,30,87,087 Xalapa,336632,157397,179235
2163,ver,30,88,088 Jalcomulco,4517,2300,2217
2164,ver,30,89,089 Jáltipan,40045,19619,20426
2165,ver,30,90,090 Jamapa,9135,4651,4484
2166,ver,30,91,091 Jesús Carranza,28936,14762,14174
2167,ver,30,92,092 Xico,27158,13428,13730
2168,ver,30,93,093 Jilotepec,12743,6268,6475
2169,ver,30,94,094 Juan Rodríguez Clara,34509,17445,17064
2170,ver,30,95,095 Juchique de Ferrer,17657,9113,8544
2171,ver,30,96,096 Landero y Coss,1599,777,822
2172,ver,30,97,097 Lerdo de Tejada,20810,9904,10906
2173,ver,30,98,098 Magdalena,1893,944,949
2174,ver,30,99,099 Maltrata,14100,6860,7240
2175,ver,30,100,100 Manlio Fabio Altamirano,20562,10400,10162
2176,ver,30,101,101 Mariano Escobedo,26301,12867,13434
2177,ver,30,102,102 Martínez de la Torre,113560,55683,57877
2178,ver,30,103,103 Mecatlán,9067,4555,4512
2179,ver,30,104,104 Mecayapan,22764,11592,11172
2180,ver,30,105,105 Medellín,32828,16312,16516
2181,ver,30,106,106 Miahuatlán,3598,1787,1811
2182,ver,30,107,107 Minas,2161,1107,1054
2183,ver,30,108,108 Minatitlán,202965,100351,102614
2184,ver,30,109,109 Misantla,59794,30146,29648
2185,ver,30,110,110 Mixtla de Altamirano,7201,3740,3461
2186,ver,30,111,111 Moloacán,17344,8708,8636
2187,ver,30,112,112 Naolinco,16976,8482,8494
2188,ver,30,113,113 Naranjal,3654,1829,1825
2189,ver,30,114,114 Nautla,9599,4805,4794
2190,ver,30,115,115 Nogales,30755,14932,15823
2191,ver,30,116,116 Oluta,13492,6634,6858
2192,ver,30,117,117 Omealca,21308,10567,10741
2193,ver,30,118,118 Orizaba,114425,53943,60482
2194,ver,30,119,119 Otatitlán,5459,2683,2776
2195,ver,30,120,120 Oteapan,12190,6011,6179
2196,ver,30,121,121 Ozuluama,25978,13506,12472
2197,ver,30,122,122 Pajapan,13073,6694,6379
2198,ver,30,123,123 Pánuco,93414,47247,46167
2199,ver,30,124,124 Papantla,171167,84170,86997
2200,ver,30,125,125 Paso del Macho,25245,12886,12359
2201,ver,30,126,126 Paso de Ovejas,30453,15459,14994
2202,ver,30,127,127 Perla,13852,7017,6835
2203,ver,30,128,128 Perote,51688,25797,25891
2204,ver,30,129,129 Platón Sánchez,18229,9270,8959
2205,ver,30,130,130 Playa Vicente,52754,26468,26286
2206,ver,30,131,131 Poza Rica de Hidalgo,154586,72689,81897
2207,ver,30,132,132 Vigas de Ramírez,13535,6745,6790
2208,ver,30,133,133 Pueblo Viejo,48054,24225,23829
2209,ver,30,134,134 Puente Nacional,19341,9759,9582
2210,ver,30,135,135 Rafael Delgado,12682,6269,6413
2211,ver,30,136,136 Rafael Lucio,4657,2297,2360
2212,ver,30,137,137 Reyes,3609,1832,1777
2213,ver,30,138,138 Río Blanco,38866,18661,20205
2214,ver,30,139,139 Saltabarranca,6289,3143,3146
2215,ver,30,140,140 San Andrés Tenejapan,1777,846,931
2216,ver,30,141,141 San Andrés Tuxtla,137435,68399,69036
2217,ver,30,142,142 San Juan Evangelista,33580,17053,16527
2218,ver,30,143,143 Santiago Tuxtla,54522,27132,27390
2219,ver,30,144,144 Sayula de Alemán,29624,15037,14587
2220,ver,30,145,145 Soconusco,11661,5854,5807
2221,ver,30,146,146 Sochiapa,2792,1414,1378
2222,ver,30,147,147 Soledad Atzompa,14801,7454,7347
2223,ver,30,148,148 Soledad de Doblado,27565,14017,13548
2224,ver,30,149,149 Soteapan,28888,14446,14442
2225,ver,30,150,150 Tamalín,11670,5909,5761
2226,ver,30,151,151 Tamiahua,27398,14044,13354
2227,ver,30,152,152 Tampico Alto,13604,7169,6435
2228,ver,30,153,153 Tancoco,7019,3509,3510
2229,ver,30,154,154 Tantima,14048,7152,6896
2230,ver,30,155,155 Tantoyuca,89492,45197,44295
2231,ver,30,156,156 Tatatila,3961,2050,1911
2232,ver,30,157,157 Castillo de Teayo,19335,9895,9440
2233,ver,30,158,158 Tecolutla,25730,13040,12690
2234,ver,30,159,159 Tehuipango,15844,7887,7957
2235,ver,30,160,160 Temapache,105404,52755,52649
2236,ver,30,161,161 Tempoal,35600,18205,17395
2237,ver,30,162,162 Tenampa,5052,2575,2477
2238,ver,30,163,163 Tenochtitlán,5142,2570,2572
2239,ver,30,164,164 Teocelo,14050,7000,7050
2240,ver,30,165,165 Tepatlaxco,6841,3592,3249
2241,ver,30,166,166 Tepetlán,8155,4315,3840
2242,ver,30,167,167 Tepetzintla,13278,6670,6608
2243,ver,30,168,168 Tequila,10676,5370,5306
2244,ver,30,169,169 José Azueta,25574,12870,12704
2245,ver,30,170,170 Texcatepec,8243,4281,3962
2246,ver,30,171,171 Texhuacán,4077,2062,2015
2247,ver,30,172,172 Texistepec,20026,10160,9866
2248,ver,30,173,173 Tezonapa,49805,25043,24762
2249,ver,30,174,174 Tierra Blanca,90123,44303,45820
2250,ver,30,175,175 Tihuatlán,81660,40571,41089
2251,ver,30,176,176 Tlacojalpan,4594,2365,2229
2252,ver,30,177,177 Tlacolulan,8307,4214,4093
2253,ver,30,178,178 Tlacotalpan,15183,7537,7646
2254,ver,30,179,179 Tlacotepec de Mejía,2906,1431,1475
2255,ver,30,180,180 Tlachichilco,10602,5413,5189
2256,ver,30,181,181 Tlalixcoyan,36697,18444,18253
2257,ver,30,182,182 Tlalnelhuayocan,9750,4848,4902
2258,ver,30,183,183 Tlapacoyan,48941,24110,24831
2259,ver,30,184,184 Tlaquilpan,5444,2686,2758
2260,ver,30,185,185 Tlilapan,3172,1569,1603
2261,ver,30,186,186 Tomatlán,5880,2954,2926
2262,ver,30,187,187 Tonayán,4563,2348,2215
2263,ver,30,188,188 Totutla,14022,7129,6893
2264,ver,30,189,189 Túxpam,127622,62171,65451
2265,ver,30,190,190 Tuxtilla,2153,1080,1073
2266,ver,30,191,191 Ursulo Galván,28158,13922,14236
2267,ver,30,192,192 Vega de Alatorre,19412,9773,9639
2268,ver,30,193,193 Veracruz,425140,202079,223061
2269,ver,30,194,194 Villa Aldama,7377,3697,3680
2270,ver,30,195,195 Xoxocotla,4212,2168,2044
2271,ver,30,196,196 Yanga,16959,8064,8895
2272,ver,30,197,197 Yecuatla,12764,6517,6247
2273,ver,30,198,198 Zacualpan,6955,3522,3433
2274,ver,30,199,199 Zaragoza,7998,3979,4019
2275,ver,30,200,200 Zentla,11562,5995,5567
2276,ver,30,201,201 Zongolica,35615,18186,17429
2277,ver,30,202,202 Zontecomatlán,11632,5845,5787
2278,ver,30,203,203 Zozocolco de Hidalgo,11346,5715,5631
2279,ver,30,204,204 Agua Dulce,46404,22921,23483
2280,ver,30,205,205 Higo,20946,10667,10279
2281,ver,30,206,206 Nanchital de Lázaro Cárdenas del Río,27183,13414,13769
2282,ver,30,207,207 Tres Valles,46175,23195,22980
2283,yuc,31,0,Total Entidad,1556622,773435,783187
2284,yuc,31,1,001 Abalá,5328,2787,2541
2285,yuc,31,2,002 Acanceh,12495,6286,6209
2286,yuc,31,3,003 Akil,8681,4359,4322
2287,yuc,31,4,004 Baca,4876,2462,2414
2288,yuc,31,5,005 Bokobá,1989,998,991
2289,yuc,31,6,006 Buctzotz,7748,3913,3835
2290,yuc,31,7,007 Cacalchén,6064,3089,2975
2291,yuc,31,8,008 Calotmul,3991,2062,1929
2292,yuc,31,9,009 Cansahcab,4848,2372,2476
2293,yuc,31,10,010 Cantamayec,2034,1062,972
2294,yuc,31,11,011 Celestún,5228,2678,2550
2295,yuc,31,12,012 Cenotillo,3680,1806,1874
2296,yuc,31,13,013 Conkal,7003,3566,3437
2297,yuc,31,14,014 Cuncunul,1245,652,593
2298,yuc,31,15,015 Cuzamá,4102,2089,2013
2299,yuc,31,16,016 Chacsinkín,2209,1149,1060
2300,yuc,31,17,017 Chankom,4100,2138,1962
2301,yuc,31,18,018 Chapab,2830,1479,1351
2302,yuc,31,19,019 Chemax,22038,11191,10847
2303,yuc,31,20,020 Chicxulub Pueblo,3423,1782,1641
2304,yuc,31,21,021 Chichimilá,5834,2919,2915
2305,yuc,31,22,022 Chikindzonot,3397,1737,1660
2306,yuc,31,23,023 Chocholá,3969,2014,1955
2307,yuc,31,24,024 Chumayel,2882,1494,1388
2308,yuc,31,25,025 Dzán,4181,2121,2060
2309,yuc,31,26,026 Dzemul,3261,1701,1560
2310,yuc,31,27,027 Dzidzantún,7675,3972,3703
2311,yuc,31,28,028 Dzilam de Bravo,2219,1170,1049
2312,yuc,31,29,029 Dzilam González,5682,2942,2740
2313,yuc,31,30,030 Dzitás,3461,1766,1695
2314,yuc,31,31,031 Dzoncauich,2844,1462,1382
2315,yuc,31,32,032 Espita,12288,6183,6105
2316,yuc,31,33,033 Halachó,16515,8460,8055
2317,yuc,31,34,034 Hocabá,5436,2748,2688
2318,yuc,31,35,035 Hoctún,5621,2756,2865
2319,yuc,31,36,036 Homún,6086,3113,2973
2320,yuc,31,37,037 Huhí,4264,2216,2048
2321,yuc,31,38,038 Hunucmá,24462,12351,12111
2322,yuc,31,39,039 Ixil,2867,1454,1413
2323,yuc,31,40,040 Izamal,23630,11742,11888
2324,yuc,31,41,041 Kanasín,33091,16566,16525
2325,yuc,31,42,042 Kantunil,5482,2817,2665
2326,yuc,31,43,043 Kaua,1931,978,953
2327,yuc,31,44,044 Kinchil,5230,2661,2569
2328,yuc,31,45,045 Kopomá,2235,1156,1079
2329,yuc,31,46,046 Mama,2701,1379,1322
2330,yuc,31,47,047 Maní,4690,2306,2384
2331,yuc,31,48,048 Maxcanú,18487,9377,9110
2332,yuc,31,49,049 Mayapán,2302,1147,1155
2333,yuc,31,50,050 Mérida,649770,314703,335067
2334,yuc,31,51,051 Mocochá,2530,1260,1270
2335,yuc,31,52,052 Motul,27755,13887,13868
2336,yuc,31,53,053 Muna,11756,6003,5753
2337,yuc,31,54,054 Muxupip,2519,1246,1273
2338,yuc,31,55,055 Opichén,5030,2590,2440
2339,yuc,31,56,056 Oxkutzcab,24005,11830,12175
2340,yuc,31,57,057 Panabá,7432,3736,3696
2341,yuc,31,58,058 Peto,21112,10652,10460
2342,yuc,31,59,059 Progreso,43892,22080,21812
2343,yuc,31,60,060 Quintana Roo,1073,545,528
2344,yuc,31,61,061 Río Lagartos,2843,1499,1344
2345,yuc,31,62,062 Sacalum,4009,2092,1917
2346,yuc,31,63,063 Samahil,4184,2128,2056
2347,yuc,31,64,064 Sanahcat,1482,736,746
2348,yuc,31,65,065 San Felipe,1641,876,765
2349,yuc,31,66,066 Santa Elena,3252,1635,1617
2350,yuc,31,67,067 Seyé,8170,4279,3891
2351,yuc,31,68,068 Sinanché,3027,1571,1456
2352,yuc,31,69,069 Sotuta,7793,4009,3784
2353,yuc,31,70,070 Sucilá,3671,1910,1761
2354,yuc,31,71,071 Sudzal,1565,790,775
2355,yuc,31,72,072 Suma,1901,981,920
2356,yuc,31,73,073 Tahdziú,2812,1422,1390
2357,yuc,31,74,074 Tahmek,3631,1871,1760
2358,yuc,31,75,075 Teabo,4848,2477,2371
2359,yuc,31,76,076 Tecoh,13724,6946,6778
2360,yuc,31,77,077 Tekal de Venegas,2318,1173,1145
2361,yuc,31,78,078 Tekantó,3971,1923,2048
2362,yuc,31,79,079 Tekax,32668,16533,16135
2363,yuc,31,80,080 Tekit,7874,4021,3853
2364,yuc,31,81,081 Tekom,2603,1305,1298
2365,yuc,31,82,082 Telchac Pueblo,3374,1724,1650
2366,yuc,31,83,083 Telchac Puerto,1413,730,683
2367,yuc,31,84,084 Temax,6672,3389,3283
2368,yuc,31,85,085 Temozón,11659,5953,5706
2369,yuc,31,86,086 Tepakán,2193,1112,1081
2370,yuc,31,87,087 Tetiz,4013,2004,2009
2371,yuc,31,88,088 Teya,2075,1058,1017
2372,yuc,31,89,089 Ticul,31028,15554,15474
2373,yuc,31,90,090 Timucuy,5407,2819,2588
2374,yuc,31,91,091 Tinum,8679,4434,4245
2375,yuc,31,92,092 Tixcacalcupul,5121,2611,2510
2376,yuc,31,93,093 Tixkokob,14746,7391,7355
2377,yuc,31,94,094 Tixmehuac,3786,1925,1861
2378,yuc,31,95,095 Tixpéhual,4663,2393,2270
2379,yuc,31,96,096 Tizimín,61447,31018,30429
2380,yuc,31,97,097 Tunkás,3694,1853,1841
2381,yuc,31,98,098 Tzucacab,12170,6220,5950
2382,yuc,31,99,099 Uayma,2804,1470,1334
2383,yuc,31,100,100 Ucú,2789,1439,1350
2384,yuc,31,101,101 Umán,45892,23144,22748
2385,yuc,31,102,102 Valladolid,52496,26038,26458
2386,yuc,31,103,103 Xocchel,2922,1516,1406
2387,yuc,31,104,104 Yaxcabá,11855,6122,5733
2388,yuc,31,105,105 Yaxkukul,2245,1154,1091
2389,yuc,31,106,106 Yobaín,1983,1027,956
2390,zac,32,0,Total Entidad,1336496,655540,680956
2391,zac,32,1,001 Apozol,7492,3599,3893
2392,zac,32,2,002 Apulco,4695,2233,2462
2393,zac,32,3,003 Atolinga,3476,1596,1880
2394,zac,32,4,004 Benito Juárez,4264,2051,2213
2395,zac,32,5,005 Calera,27454,13700,13754
2396,zac,32,6,006 Cañitas de Felipe Pescador,9069,4506,4563
2397,zac,32,7,007 Concepción del Oro,12557,6392,6165
2398,zac,32,8,008 Cuauhtémoc,10389,5155,5234
2399,zac,32,9,009 Chalchihuites,13019,6353,6666
2400,zac,32,10,010 Fresnillo,176885,87216,89669
2401,zac,32,11,011 Trinidad García de la Cadena,3710,1752,1958
2402,zac,32,12,012 Genaro Codina,8260,4173,4087
2403,zac,32,13,013 General Enrique Estrada,5255,2636,2619
2404,zac,32,14,014 General Francisco R. Murguía,25779,12707,13072
2405,zac,32,15,015 General Joaquín Amaro,2139,990,1149
2406,zac,32,16,016 General Pánfilo Natera,21641,10664,10977
2407,zac,32,17,017 Guadalupe,107523,52900,54623
2408,zac,32,18,018 Huanusco,5700,2664,3036
2409,zac,32,19,019 Jalpa,23883,11460,12423
2410,zac,32,20,020 Jerez,56180,26705,29475
2411,zac,32,21,021 Jiménez del Teul,5110,2488,2622
2412,zac,32,22,022 Juan Aldama,20056,9863,10193
2413,zac,32,23,023 Juchipila,12815,6000,6815
2414,zac,32,24,024 Loreto,36282,17985,18297
2415,zac,32,25,025 Luis Moya,11488,5665,5823
2416,zac,32,26,026 Mazapil,20969,11002,9967
2417,zac,32,27,027 Melchor Ocampo,2843,1550,1293
2418,zac,32,28,028 Mezquital del Oro,3153,1513,1640
2419,zac,32,29,029 Miguel Auza,21024,10310,10714
2420,zac,32,30,030 Momax,3228,1501,1727
2421,zac,32,31,031 Monte Escobedo,9800,4607,5193
2422,zac,32,32,032 Morelos,9176,4646,4530
2423,zac,32,33,033 Moyahua de Estrada,5986,2793,3193
2424,zac,32,34,034 Nochistlán de Mejía,30567,13961,16606
2425,zac,32,35,035 Noria de Ángeles,13461,6766,6695
2426,zac,32,36,036 Ojocaliente,36191,17755,18436
2427,zac,32,37,037 Pánuco,13645,6837,6808
2428,zac,32,38,038 Pinos,63549,31944,31605
2429,zac,32,39,039 Río Grande,60559,29708,30851
2430,zac,32,40,040 Sain Alto,21779,10722,11057
2431,zac,32,41,041 Salvador,3798,1952,1846
2432,zac,32,42,042 Sombrerete,65252,32528,32724
2433,zac,32,43,043 Susticacán,1453,685,768
2434,zac,32,44,044 Tabasco,15446,7458,7988
2435,zac,32,45,045 Tepechitlán,9193,4348,4845
2436,zac,32,46,046 Tepetongo,9116,4225,4891
2437,zac,32,47,047 Teul de González Ortega,9327,4543,4784
2438,zac,32,48,048 Tlaltenango de Sánchez Román,23670,11653,12017
2439,zac,32,49,049 Valparaíso,36393,17514,18879
2440,zac,32,50,050 Vetagrande,6969,3506,3463
2441,zac,32,51,051 Villa de Cos,32502,16529,15973
2442,zac,32,52,052 Villa García,13467,6769,6698
2443,zac,32,53,053 Villa González Ortega,11613,5648,5965
2444,zac,32,54,054 Villa Hidalgo,16490,8263,8227
2445,zac,32,55,055 Villanueva,32014,15399,16615
2446,zac,32,56,056 Zacatecas,118742,57452,61290
